PROV;DEPRE;EDAD;VARON;MUJER;TOTAL
6;427;0;17117;16924;34041
6;427;19;17071;17375;34446
6;427;15;16874;15977;32851
6;427;14;16790;16677;33467
6;427;20;16677;17018;33695
6;427;2;16585;15727;32312
6;427;18;16343;16380;32723
6;427;5;16329;15871;32200
6;427;12;16289;15599;31888
6;427;1;16270;16048;32318
6;427;6;16259;15751;32010
6;427;10;16141;15154;31295
6;427;17;16093;15576;31669
6;427;16;15993;16710;32703
6;427;13;15940;15125;31065
6;427;3;15857;15149;31006
6;427;4;15617;15395;31012
6;427;9;15517;15988;31505
6;427;11;15464;14568;30032
6;427;7;15381;15134;30515
6;427;22;15309;15134;30443
6;427;21;15252;15314;30566
6;427;30;15125;15275;30400
6;427;23;14749;15209;29958
6;427;28;14574;14846;29420
6;427;8;14494;14957;29451
6;427;33;14366;13969;28335
6;427;24;14350;15173;29523
6;427;29;14018;14827;28845
6;427;26;13763;12999;26762
6;427;31;13711;13949;27660
6;427;32;13699;14699;28398
6;427;27;13559;14444;28003
6;427;34;13251;13083;26334
6;427;35;13212;13141;26353
6;427;25;13166;15242;28408
6;427;38;12521;12571;25092
6;427;36;11827;11295;23122
6;427;37;11501;12198;23699
6;427;40;11152;12044;23196
6;427;39;10940;13073;24013
6;427;41;10753;11844;22597
6;427;43;10321;9739;20060
6;427;42;9881;10695;20576
6;427;45;9820;10338;20158
6;427;46;9785;10552;20337
6;427;49;9475;8817;18292
6;427;50;9416;9770;19186
6;427;44;9343;9458;18801
6;427;47;9216;9803;19019
6;427;48;9061;9752;18813
6;427;52;8281;8870;17151
6;427;53;8198;8820;17018
6;427;51;8039;9104;17143
6;427;54;7706;8292;15998
6;427;55;7625;8381;16006
6;427;57;7091;7675;14766
6;427;60;7057;8106;15163
6;427;56;7024;7611;14635
6;427;58;6986;8136;15122
6;427;59;6647;8252;14899
6;441;21;6495;5858;12353
6;441;20;6383;6531;12914
6;427;61;6251;7129;13380
6;427;63;6220;6381;12601
6;427;62;6148;7688;13836
6;441;30;6084;5806;11890
6;441;22;5942;6296;12238
6;441;23;5913;6414;12327
6;441;24;5835;5907;11742
6;441;25;5779;5961;11740
6;490;15;5730;5061;10791
6;441;19;5684;6116;11800
6;490;10;5674;5194;10868
6;490;18;5657;4753;10410
6;28;15;5635;4740;10375
6;441;29;5536;5557;11093
6;441;0;5531;4973;10504
6;441;28;5520;5873;11393
6;441;31;5491;5339;10830
6;28;1;5475;4642;10117
6;490;19;5446;5098;10544
6;28;16;5441;4712;10153
6;427;64;5434;5803;11237
6;28;18;5393;5122;10515
6;28;20;5379;5048;10427
6;28;12;5370;4996;10366
6;539;14;5363;5458;10821
6;490;20;5344;6003;11347
6;658;0;5328;5300;10628
6;357;14;5326;4631;9957
6;357;24;5309;4598;9907
6;490;24;5308;4910;10218
6;427;65;5307;6187;11494
6;28;14;5305;5004;10309
6;490;2;5278;4629;9907
6;490;1;5274;5635;10909
6;441;14;5262;5098;10360
6;539;0;5255;4607;9862
6;490;32;5243;5322;10565
6;658;2;5237;4882;10119
6;441;27;5229;5622;10851
6;560;14;5228;4167;9395
6;357;19;5227;4730;9957
6;539;4;5208;4782;9990
6;560;15;5205;4896;10101
6;539;8;5205;4599;9804
6;28;13;5191;5004;10195
6;658;4;5184;4755;9939
6;441;1;5160;4781;9941
6;560;6;5145;4163;9308
6;490;0;5133;4854;9987
6;490;26;5130;4413;9543
6;28;5;5129;4838;9967
6;441;8;5124;4522;9646
6;28;6;5106;4485;9591
6;441;33;5095;5499;10594
6;490;14;5094;4785;9879
6;441;6;5094;5027;10121
6;490;28;5074;5195;10269
6;441;4;5074;4881;9955
6;357;15;5073;4690;9763
6;490;17;5062;4907;9969
6;658;14;5061;4706;9767
6;658;24;5060;4773;9833
6;441;34;5057;4846;9903
6;539;2;5052;5215;10267
6;441;37;5039;4462;9501
6;357;6;5037;4840;9877
6;28;8;5034;4187;9221
6;539;18;5030;4588;9618
6;28;0;5022;5029;10051
6;490;27;5020;4858;9878
6;539;20;5015;4881;9896
6;658;6;5012;4575;9587
6;441;2;5005;4658;9663
6;539;3;5003;4813;9816
6;539;19;5002;4783;9785
6;441;26;5000;5523;10523
6;490;31;4998;4490;9488
6;441;17;4994;4711;9705
6;357;8;4993;4379;9372
6;658;8;4982;4548;9530
6;539;15;4977;4910;9887
6;490;22;4967;4989;9956
6;441;9;4967;4588;9555
6;490;21;4965;4999;9964
6;539;24;4964;4143;9107
6;28;17;4961;4888;9849
6;441;32;4957;5346;10303
6;539;10;4953;4826;9779
6;28;19;4947;5256;10203
6;658;19;4943;5237;10180
6;441;7;4943;4790;9733
6;490;23;4934;5784;10718
6;539;22;4929;4652;9581
6;658;23;4925;4929;9854
6;490;9;4923;4604;9527
6;490;3;4921;4750;9671
6;441;15;4917;5017;9934
6;441;16;4912;4462;9374
6;357;20;4911;5137;10048
6;539;6;4905;4716;9621
6;441;10;4903;4931;9834
6;441;3;4903;4741;9644
6;539;16;4902;4885;9787
6;441;18;4900;5574;10474
6;658;10;4896;5025;9921
6;539;9;4880;4528;9408
6;539;7;4879;4518;9397
6;490;16;4877;4700;9577
6;28;24;4876;4382;9258
6;560;1;4870;3938;8808
6;357;21;4864;4510;9374
6;28;9;4864;4664;9528
6;539;1;4864;4986;9850
6;490;4;4861;5185;10046
6;560;2;4861;4482;9343
6;427;66;4848;5596;10444
6;357;18;4846;4907;9753
6;490;33;4843;5197;10040
6;658;30;4835;5011;9846
6;28;28;4833;4494;9327
6;658;16;4826;4899;9725
6;490;7;4823;4483;9306
6;539;11;4821;4404;9225
6;560;20;4798;4830;9628
6;490;5;4797;5161;9958
6;28;11;4783;4436;9219
6;539;23;4780;4437;9217
6;490;30;4772;5003;9775
6;658;3;4770;4686;9456
6;28;3;4761;4696;9457
6;274;1;4758;4454;9212
6;539;17;4756;4902;9658
6;658;1;4737;4529;9266
6;539;12;4735;4593;9328
6;658;28;4733;4819;9552
6;490;29;4732;5042;9774
6;658;33;4722;4464;9186
6;560;9;4722;4251;8973
6;357;4;4718;4417;9135
6;28;10;4711;5120;9831
6;658;18;4709;5053;9762
6;658;20;4708;4813;9521
6;28;21;4703;4917;9620
6;357;28;4699;4758;9457
6;441;35;4692;5176;9868
6;441;11;4692;4252;8944
6;658;31;4689;4741;9430
6;658;15;4684;4900;9584
6;490;6;4679;5136;9815
6;560;11;4674;4246;8920
6;658;7;4663;4541;9204
6;357;16;4662;4657;9319
6;539;13;4661;4730;9391
6;28;4;4659;5161;9820
6;441;5;4649;4657;9306
6;274;16;4648;4501;9149
6;28;7;4630;4796;9426
6;658;21;4627;5052;9679
6;357;10;4611;4437;9048
6;357;23;4599;4864;9463
6;658;11;4598;4568;9166
6;560;0;4598;5195;9793
6;28;2;4597;5072;9669
6;490;8;4596;4550;9146
6;357;7;4596;4004;8600
6;539;5;4591;4911;9502
6;357;29;4589;4590;9179
6;28;25;4580;4270;8850
6;441;12;4577;4234;8811
6;658;22;4576;4914;9490
6;658;5;4570;4483;9053
6;658;12;4568;4359;8927
6;427;68;4558;5095;9653
6;357;13;4555;4550;9105
6;658;32;4547;4796;9343
6;28;22;4546;4936;9482
6;427;67;4544;5421;9965
6;490;25;4544;5005;9549
6;539;30;4535;4472;9007
6;490;13;4529;5128;9657
6;274;3;4526;3916;8442
6;357;12;4521;4472;8993
6;274;12;4515;4077;8592
6;274;14;4514;4406;8920
6;28;27;4513;4191;8704
6;274;9;4508;4341;8849
6;560;16;4504;4289;8793
6;658;9;4502;4400;8902
6;357;11;4493;4152;8645
6;441;40;4491;4452;8943
6;658;25;4477;4274;8751
6;274;15;4468;4366;8834
6;357;34;4463;4696;9159
6;357;26;4451;4167;8618
6;357;30;4449;4299;8748
6;28;29;4449;3873;8322
6;539;31;4445;4306;8751
6;274;10;4439;4311;8750
6;658;27;4436;4614;9050
6;441;13;4436;4708;9144
6;560;8;4435;4412;8847
6;274;11;4433;4227;8660
6;560;5;4431;4415;8846
6;658;17;4429;4752;9181
6;274;20;4426;4054;8480
6;560;17;4424;3704;8128
6;490;35;4422;4643;9065
6;560;21;4421;3999;8420
6;539;21;4420;4680;9100
6;441;36;4415;4703;9118
6;560;10;4407;4226;8633
6;28;23;4405;4938;9343
6;274;2;4403;3931;8334
6;274;6;4394;4250;8644
6;274;0;4384;4657;9041
6;490;12;4383;4321;8704
6;357;1;4382;4180;8562
6;560;13;4375;4298;8673
6;658;26;4374;4671;9045
6;441;38;4372;5060;9432
6;357;27;4361;4542;8903
6;357;22;4352;4389;8741
6;357;5;4345;4518;8863
6;274;18;4330;4221;8551
6;539;28;4326;4709;9035
6;357;17;4323;4757;9080
6;357;40;4322;4297;8619
6;490;37;4317;4029;8346
6;357;0;4315;3959;8274
6;28;30;4309;4877;9186
6;658;34;4301;4484;8785
6;658;13;4301;4608;8909
6;28;31;4298;4310;8608
6;490;38;4292;4392;8684
6;560;18;4279;4492;8771
6;560;29;4271;4080;8351
6;441;39;4270;4673;8943
6;658;29;4262;4603;8865
6;274;5;4256;3900;8156
6;28;32;4255;4465;8720
6;357;9;4235;4237;8472
6;274;8;4225;4092;8317
6;274;17;4217;4034;8251
6;357;31;4211;4251;8462
6;490;11;4186;4196;8382
6;357;35;4165;4219;8384
6;560;24;4159;4176;8335
6;357;2;4135;4024;8159
6;274;13;4134;4002;8136
6;490;39;4116;4051;8167
6;427;70;4113;5373;9486
6;490;36;4112;3832;7944
6;274;7;4103;4494;8597
6;560;3;4100;4691;8791
6;441;42;4089;3973;8062
6;560;22;4076;3545;7621
6;274;19;4074;4533;8607
6;539;29;4071;4581;8652
6;357;36;4061;3956;8017
6;539;33;4048;4253;8301
6;28;26;4035;3982;8017
6;357;25;4035;4321;8356
6;357;3;4015;3951;7966
6;658;37;4012;3976;7988
6;357;33;4011;4356;8367
6;658;40;4001;3947;7948
6;560;7;3999;4474;8473
6;274;28;3997;3815;7812
6;560;12;3995;4285;8280
6;28;33;3979;4240;8219
6;539;25;3977;4153;8130
6;441;46;3960;3634;7594
6;357;50;3957;3617;7574
6;441;41;3947;4045;7992
6;274;4;3944;4359;8303
6;560;30;3941;3356;7297
6;539;32;3924;4364;8288
6;560;4;3920;4058;7978
6;658;38;3919;4004;7923
6;274;23;3910;3925;7835
6;274;21;3883;3684;7567
6;357;37;3879;4484;8363
6;805;4;3871;3352;7223
6;274;26;3861;3480;7341
6;427;69;3855;4694;8549
6;539;27;3855;4261;8116
6;357;32;3854;4344;8198
6;274;24;3850;3543;7393
6;539;39;3849;3532;7381
6;434;30;3844;3534;7378
6;658;35;3841;4079;7920
6;539;34;3808;3877;7685
6;658;36;3797;4008;7805
6;274;22;3794;3660;7454
6;490;34;3787;4358;8145
6;490;50;3783;3930;7713
6;560;28;3773;3912;7685
6;560;19;3758;4444;8202
6;805;11;3756;3455;7211
6;539;26;3753;4249;8002
6;805;1;3742;3606;7348
6;441;43;3739;3580;7319
6;805;5;3736;3343;7079
6;28;40;3730;3692;7422
6;805;2;3722;3329;7051
6;539;35;3720;3960;7680
6;539;40;3685;3563;7248
6;28;35;3685;3873;7558
6;434;23;3680;3549;7229
6;441;44;3679;3756;7435
6;490;40;3675;4714;8389
6;28;34;3662;3897;7559
6;357;39;3661;4009;7670
6;434;20;3660;3561;7221
6;371;3;3636;2902;6538
6;658;39;3635;3720;7355
6;357;44;3634;3747;7381
6;805;7;3630;3408;7038
6;805;6;3618;3481;7099
6;560;26;3615;3311;6926
6;357;48;3609;3741;7350
6;28;38;3605;3511;7116
6;427;71;3604;4457;8061
6;371;9;3602;3005;6607
6;805;12;3587;3334;6921
6;434;8;3577;3027;6604
6;274;31;3576;3344;6920
6;805;15;3576;3487;7063
6;434;31;3575;3705;7280
6;357;43;3566;3424;6990
6;805;14;3564;3266;6830
6;805;0;3561;2938;6499
6;490;41;3559;4020;7579
6;434;21;3554;3337;6891
6;357;42;3549;3928;7477
6;658;50;3548;3089;6637
6;560;23;3544;4446;7990
6;357;46;3541;3914;7455
6;434;34;3535;3496;7031
6;434;22;3534;3320;6854
6;434;14;3519;3172;6691
6;805;9;3514;3264;6778
6;357;51;3503;3623;7126
6;371;17;3493;2937;6430
6;434;32;3489;3664;7153
6;274;33;3479;3397;6876
6;274;25;3478;3451;6929
6;434;27;3477;3608;7085
6;560;33;3473;3574;7047
6;274;29;3473;3257;6730
6;434;15;3473;3239;6712
6;441;50;3465;3521;6986
6;490;47;3465;3799;7264
6;560;37;3458;2974;6432
6;357;47;3451;3611;7062
6;371;21;3450;3247;6697
6;28;36;3449;3654;7103
6;357;41;3446;4600;8046
6;441;54;3428;3639;7067
6;357;38;3423;4377;7800
6;434;19;3421;3683;7104
6;434;29;3419;3570;6989
6;434;24;3418;3352;6770
6;441;48;3409;3525;6934
6;371;20;3407;3213;6620
6;434;0;3406;3291;6697
6;441;49;3393;3673;7066
6;28;37;3387;3890;7277
6;274;27;3376;3252;6628
6;805;3;3376;3135;6511
6;441;45;3374;3516;6890
6;638;14;3373;3164;6537
6;560;36;3371;3180;6551
6;434;18;3371;3639;7010
6;638;5;3365;3138;6503
6;371;30;3364;3705;7069
6;490;49;3362;3540;6902
6;515;18;3362;2980;6342
6;805;19;3361;3740;7101
6;434;33;3357;3546;6903
6;658;41;3351;3494;6845
6;490;46;3349;3352;6701
6;441;47;3347;3763;7110
6;434;4;3343;2872;6215
6;805;16;3339;2901;6240
6;638;0;3337;2921;6258
6;658;42;3332;3677;7009
6;490;48;3330;3289;6619
6;434;28;3329;3865;7194
6;638;10;3326;3237;6563
6;434;7;3326;3028;6354
6;805;10;3322;3559;6881
6;539;36;3321;3148;6469
6;560;35;3321;3944;7265
6;357;57;3320;4006;7326
6;434;35;3320;3310;6630
6;371;22;3320;3596;6916
6;434;1;3319;3234;6553
6;490;44;3314;3300;6614
6;441;53;3305;3411;6716
6;434;26;3305;3299;6604
6;357;49;3302;3557;6859
6;371;14;3298;3293;6591
6;28;39;3296;3625;6921
6;371;31;3296;3092;6388
6;357;45;3288;3852;7140
6;638;2;3285;2937;6222
6;539;37;3282;3470;6752
6;371;34;3282;2557;5839
6;434;12;3278;3020;6298
6;805;8;3278;3199;6477
6;434;5;3274;3555;6829
6;371;25;3271;2937;6208
6;274;30;3270;3258;6528
6;434;2;3267;3285;6552
6;434;9;3264;2741;6005
6;434;10;3258;2814;6072
6;357;53;3247;3607;6854
6;805;17;3247;2946;6193
6;371;10;3245;3278;6523
6;658;43;3244;3331;6575
6;357;55;3240;3479;6719
6;434;25;3240;3782;7022
6;805;20;3235;3430;6665
6;274;32;3234;3254;6488
6;560;31;3234;3971;7205
6;371;27;3233;3247;6480
6;515;14;3233;3203;6436
6;805;39;3232;2716;5948
6;371;29;3230;3356;6586
6;441;52;3226;3688;6914
6;371;1;3223;3122;6345
6;805;18;3216;3265;6481
6;434;17;3216;3274;6490
6;638;9;3212;2887;6099
6;560;27;3209;3554;6763
6;658;45;3203;2963;6166
6;260;19;3192;2947;6139
6;434;3;3180;2970;6150
6;490;53;3178;3468;6646
6;658;47;3174;3174;6348
6;515;10;3171;3031;6202
6;515;19;3170;2843;6013
6;560;25;3165;3689;6854
6;371;15;3157;2984;6141
6;371;24;3155;3387;6542
6;371;28;3151;3150;6301
6;539;41;3149;3216;6365
6;638;11;3147;2984;6131
6;568;35;3144;1924;5068
6;91;5;3142;3095;6237
6;434;16;3140;3327;6467
6;490;45;3139;3483;6622
6;638;1;3139;2964;6103
6;638;7;3135;2975;6110
6;539;38;3134;3265;6399
6;490;42;3132;3496;6628
6;28;44;3130;2991;6121
6;658;48;3125;3397;6522
6;638;6;3123;2820;5943
6;658;49;3119;3285;6404
6;357;52;3114;3716;6830
6;371;18;3113;3228;6341
6;434;40;3112;3028;6140
6;434;13;3110;3173;6283
6;434;37;3108;3316;6424
6;260;14;3107;2928;6035
6;371;7;3104;2860;5964
6;371;19;3103;3730;6833
6;427;73;3102;4236;7338
6;28;47;3101;3250;6351
6;515;15;3101;2630;5731
6;371;0;3099;3082;6181
6;658;51;3098;3017;6115
6;56;20;3098;2776;5874
6;515;9;3095;2863;5958
6;371;37;3090;2963;6053
6;805;13;3084;3184;6268
6;357;58;3079;3636;6715
6;28;43;3070;3271;6341
6;371;23;3063;3458;6521
6;91;19;3062;3142;6204
6;371;11;3062;2917;5979
6;371;26;3061;3118;6179
6;357;54;3051;3716;6767
6;515;8;3041;2732;5773
6;805;22;3040;2830;5870
6;638;8;3040;2837;5877
6;91;2;3037;3098;6135
6;638;4;3036;3093;6129
6;515;3;3032;2661;5693
6;434;36;3031;2939;5970
6;434;6;3031;3350;6381
6;658;46;3020;3218;6238
6;28;46;3018;3254;6272
6;427;72;3016;3843;6859
6;805;21;3013;2920;5933
6;515;17;3013;2711;5724
6;805;30;3012;3005;6017
6;638;12;3010;2926;5936
6;756;20;3008;1871;4879
6;515;7;3008;3089;6097
6;560;39;3007;2921;5928
6;91;18;3002;2654;5656
6;490;56;3000;3164;6164
6;805;36;3000;2982;5982
6;515;20;2992;2686;5678
6;434;38;2990;2898;5888
6;805;23;2988;2917;5905
6;515;12;2986;2683;5669
6;260;2;2986;3008;5994
6;28;42;2985;3232;6217
6;490;43;2979;3492;6471
6;357;62;2978;3478;6456
6;490;58;2976;3291;6267
6;568;33;2976;3181;6157
6;371;32;2973;3323;6296
6;371;33;2969;3218;6187
6;515;1;2965;3065;6030
6;371;40;2964;3092;6056
6;560;38;2964;3162;6126
6;371;6;2964;3040;6004
6;515;13;2963;2691;5654
6;515;4;2959;2607;5566
6;371;35;2956;3281;6237
6;260;10;2953;2616;5569
6;274;38;2952;3539;6491
6;28;51;2951;2918;5869
6;658;53;2950;3076;6026
6;805;28;2943;2840;5783
6;441;60;2941;3365;6306
6;28;50;2940;3216;6156
6;638;16;2939;3099;6038
6;260;0;2933;2696;5629
6;490;52;2931;3398;6329
6;91;21;2927;2736;5663
6;515;5;2927;3086;6013
6;515;11;2926;2677;5603
6;434;11;2926;3220;6146
6;91;7;2924;2441;5365
6;91;6;2924;2670;5594
6;28;41;2923;3177;6100
6;260;1;2921;2885;5806
6;274;40;2920;2665;5585
6;371;5;2920;2834;5754
6;274;35;2919;2942;5861
6;260;13;2918;2601;5519
6;515;0;2917;3000;5917
6;260;6;2914;2832;5746
6;357;56;2908;3390;6298
6;260;8;2908;2536;5444
6;412;14;2899;2512;5411
6;412;0;2896;2619;5515
6;441;56;2895;3412;6307
6;434;39;2895;3362;6257
6;840;30;2895;2872;5767
6;28;48;2893;3079;5972
6;638;15;2892;2828;5720
6;490;54;2889;3193;6082
6;35;18;2889;2621;5510
6;441;55;2887;3390;6277
6;91;8;2884;2520;5404
6;91;9;2881;2718;5599
6;515;6;2881;2721;5602
6;357;63;2880;3348;6228
6;91;23;2878;2679;5557
6;658;44;2873;3305;6178
6;515;2;2873;3144;6017
6;434;50;2870;2626;5496
6;91;16;2868;2771;5639
6;357;59;2866;3469;6335
6;560;32;2865;3554;6419
6;35;28;2864;2775;5639
6;560;34;2859;3408;6267
6;91;12;2853;3094;5947
6;91;3;2852;2603;5455
6;539;47;2841;3219;6060
6;91;13;2839;2522;5361
6;274;37;2835;3105;5940
6;91;28;2834;2476;5310
6;434;42;2833;2793;5626
6;805;34;2831;2702;5533
6;515;23;2830;2950;5780
6;568;18;2829;2214;5043
6;35;19;2825;3005;5830
6;91;22;2822;2837;5659
6;427;75;2821;3692;6513
6;260;17;2821;2734;5555
6;35;33;2818;2893;5711
6;260;22;2818;2479;5297
6;441;51;2816;3559;6375
6;28;45;2814;3345;6159
6;490;51;2813;3865;6678
6;91;20;2812;2967;5779
6;638;18;2812;2700;5512
6;260;18;2812;2698;5510
6;371;4;2808;3200;6008
6;91;17;2807;2608;5415
6;35;7;2803;2755;5558
6;560;41;2800;2501;5301
6;638;3;2796;2848;5644
6;441;57;2795;3223;6018
6;274;39;2787;2631;5418
6;91;14;2787;3118;5905
6;260;7;2787;2523;5310
6;371;16;2786;3020;5806
6;56;22;2783;2678;5461
6;539;50;2781;2723;5504
6;840;24;2779;2634;5413
6;91;15;2778;2904;5682
6;434;41;2772;2789;5561
6;260;3;2769;2830;5599
6;28;54;2768;2947;5715
6;274;36;2760;2918;5678
6;515;30;2760;3045;5805
6;260;4;2759;2508;5267
6;412;2;2759;2543;5302
6;28;49;2757;3308;6065
6;91;11;2757;2628;5385
6;91;27;2756;2091;4847
6;805;25;2756;2844;5600
6;805;29;2755;3163;5918
6;91;10;2755;3146;5901
6;371;43;2754;2754;5508
6;28;56;2753;2695;5448
6;568;24;2752;2112;4864
6;658;58;2751;2850;5601
6;515;21;2749;2752;5501
6;56;23;2748;2775;5523
6;658;55;2747;3280;6027
6;638;13;2746;3055;5801
6;274;41;2745;2758;5503
6;260;5;2744;2783;5527
6;371;39;2739;2981;5720
6;568;20;2736;2247;4983
6;515;31;2733;2853;5586
6;260;9;2733;2739;5472
6;805;33;2732;3380;6112
6;35;30;2731;2788;5519
6;412;18;2729;2773;5502
6;260;15;2729;2944;5673
6;357;61;2727;3553;6280
6;539;43;2726;2805;5531
6;515;22;2725;2828;5553
6;91;1;2724;2658;5382
6;260;12;2722;2740;5462
6;412;4;2719;2413;5132
6;840;31;2715;2525;5240
6;56;24;2713;3061;5774
6;371;12;2712;3196;5908
6;357;64;2711;3483;6194
6;91;32;2708;2730;5438
6;805;38;2707;3327;6034
6;91;0;2707;2866;5573
6;658;52;2706;3081;5787
6;91;4;2704;2669;5373
6;490;61;2700;2658;5358
6;568;6;2698;2304;5002
6;260;20;2697;2784;5481
6;568;23;2689;2172;4861
6;658;54;2685;3190;5875
6;35;35;2685;2554;5239
6;35;31;2683;2800;5483
6;515;16;2683;2859;5542
6;805;24;2678;3067;5745
6;371;2;2676;3132;5808
6;560;42;2675;2476;5151
6;260;16;2674;2582;5256
6;638;21;2673;2520;5193
6;805;31;2672;2913;5585
6;28;55;2668;2757;5425
6;357;60;2666;3675;6341
6;490;55;2665;3206;5871
6;658;60;2664;2858;5522
6;490;59;2661;2798;5459
6;515;26;2658;2362;5020
6;28;53;2657;2659;5316
6;434;54;2653;2889;5542
6;560;44;2653;2172;4825
6;274;42;2652;2388;5040
6;274;34;2651;2974;5625
6;539;45;2644;2803;5447
6;35;1;2643;2422;5065
6;840;27;2636;2737;5373
6;539;44;2634;2840;5474
6;568;32;2634;2436;5070
6;260;11;2634;2791;5425
6;35;6;2633;2481;5114
6;91;33;2632;2603;5235
6;357;66;2628;2920;5548
6;56;18;2625;2640;5265
6;260;23;2623;2710;5333
6;760;5;2620;2349;4969
6;840;20;2619;2930;5549
6;412;3;2615;2302;4917
6;56;26;2614;2430;5044
6;568;27;2611;1934;4545
6;760;21;2611;2744;5355
6;412;16;2611;2254;4865
6;441;62;2610;2947;5557
6;35;20;2610;2436;5046
6;760;14;2609;2292;4901
6;515;33;2608;2354;4962
6;371;13;2606;3167;5773
6;760;2;2606;2238;4844
6;840;19;2605;2703;5308
6;515;24;2604;2835;5439
6;539;51;2603;2471;5074
6;515;28;2603;2701;5304
6;805;40;2602;2833;5435
6;412;20;2601;2689;5290
6;568;12;2600;1647;4247
6;35;10;2600;2396;4996
6;638;20;2598;2640;5238
6;760;18;2595;2774;5369
6;441;59;2594;3312;5906
6;840;23;2590;2591;5181
6;658;59;2588;2930;5518
6;35;23;2588;2596;5184
6;840;28;2587;2504;5091
6;638;23;2587;2502;5089
6;260;28;2584;2564;5148
6;840;32;2583;2637;5220
6;840;34;2582;2668;5250
6;840;7;2582;2277;4859
6;638;22;2581;2495;5076
6;412;12;2579;2503;5082
6;412;1;2579;2976;5555
6;539;53;2575;2549;5124
6;35;32;2572;2890;5462
6;434;51;2570;2581;5151
6;35;29;2568;2580;5148
6;434;57;2567;2710;5277
6;260;27;2567;2383;4950
6;412;11;2566;2621;5187
6;35;25;2563;2475;5038
6;412;6;2563;2893;5456
6;760;23;2559;2680;5239
6;434;49;2557;2942;5499
6;840;25;2554;2479;5033
6;371;38;2548;2688;5236
6;760;29;2548;1956;4504
6;412;13;2548;2352;4900
6;638;19;2544;2665;5209
6;371;8;2544;2461;5005
6;441;61;2543;3050;5593
6;412;8;2543;2776;5319
6;434;48;2541;2847;5388
6;412;15;2541;2887;5428
6;805;35;2540;3164;5704
6;35;24;2540;2720;5260
6;35;14;2538;2420;4958
6;840;11;2538;2274;4812
6;35;21;2536;2488;5024
6;760;10;2534;2176;4710
6;412;10;2530;2729;5259
6;427;74;2528;3891;6419
6;805;32;2528;3009;5537
6;28;52;2527;2973;5500
6;805;27;2525;2562;5087
6;760;20;2525;2541;5066
6;35;15;2525;2685;5210
6;658;62;2521;2591;5112
6;260;30;2520;2536;5056
6;760;1;2519;2022;4541
6;56;28;2518;2644;5162
6;434;55;2512;2872;5384
6;91;29;2512;2473;4985
6;260;21;2509;2640;5149
6;805;26;2508;3035;5543
6;638;17;2506;2828;5334
6;260;29;2505;2402;4907
6;35;2;2500;2475;4975
6;56;25;2498;2622;5120
6;760;16;2498;2382;4880
6;515;32;2497;2484;4981
6;515;25;2497;2867;5364
6;840;22;2497;2700;5197
6;434;47;2496;2998;5494
6;539;42;2493;3250;5743
6;56;19;2492;2800;5292
6;35;9;2490;2247;4737
6;56;29;2489;2363;4852
6;539;46;2488;3073;5561
6;441;58;2484;3093;5577
6;560;45;2482;2981;5463
6;861;21;2482;2179;4661
6;412;7;2482;2555;5037
6;568;26;2480;2080;4560
6;434;46;2479;2885;5364
6;560;43;2478;2273;4751
6;840;26;2477;2656;5133
6;658;56;2476;3214;5690
6;539;49;2475;2776;5251
6;840;35;2475;2431;4906
6;840;40;2471;2182;4653
6;35;11;2471;2387;4858
6;260;24;2468;2980;5448
6;357;65;2467;2983;5450
6;840;21;2466;2297;4763
6;35;0;2466;2461;4927
6;35;22;2464;2681;5145
6;539;56;2463;2469;4932
6;412;5;2461;2402;4863
6;434;43;2459;2714;5173
6;760;19;2458;2541;4999
6;91;26;2456;2869;5325
6;35;12;2455;2430;4885
6;490;60;2450;3182;5632
6;638;31;2450;2612;5062
6;434;53;2449;2866;5315
6;638;25;2448;2604;5052
6;658;61;2447;2623;5070
6;371;48;2447;2522;4969
6;91;30;2447;2677;5124
6;539;48;2446;3007;5453
6;515;35;2444;2255;4699
6;412;19;2444;2421;4865
6;805;37;2443;2820;5263
6;638;24;2442;2275;4717
6;56;16;2442;2105;4547
6;840;6;2442;2452;4894
6;35;16;2436;2285;4721
6;568;0;2433;2099;4532
6;35;8;2432;2618;5050
6;840;14;2431;2488;4919
6;539;57;2429;2437;4866
6;840;4;2429;2188;4617
6;756;4;2428;1871;4299
6;568;25;2421;2307;4728
6;560;40;2420;2913;5333
6;840;29;2420;2484;4904
6;515;27;2420;2607;5027
6;434;60;2419;2697;5116
6;658;57;2418;2811;5229
6;371;57;2418;2313;4731
6;840;18;2417;2242;4659
6;260;31;2415;2497;4912
6;412;32;2413;2021;4434
6;568;19;2413;2441;4854
6;56;0;2413;2085;4498
6;805;45;2412;2208;4620
6;490;57;2411;3140;5551
6;840;15;2410;2539;4949
6;371;55;2408;2282;4690
6;760;30;2408;2344;4752
6;412;21;2407;2412;4819
6;840;9;2404;2395;4799
6;568;30;2402;2805;5207
6;638;37;2401;2126;4527
6;760;24;2401;2475;4876
6;568;9;2401;2105;4506
6;252;14;2400;2333;4733
6;371;44;2396;2398;4794
6;760;17;2396;2283;4679
6;760;4;2395;2398;4793
6;638;28;2394;2523;4917
6;56;21;2394;2701;5095
6;539;52;2392;2938;5330
6;515;34;2392;2381;4773
6;91;24;2392;2809;5201
6;412;9;2390;2458;4848
6;760;22;2389;2246;4635
6;568;21;2389;2241;4630
6;840;17;2389;2433;4822
6;805;41;2388;2764;5152
6;371;42;2383;2306;4689
6;371;36;2383;3094;5477
6;434;45;2382;2895;5277
6;840;38;2382;2106;4488
6;560;47;2381;2621;5002
6;515;29;2378;2601;4979
6;35;3;2378;2343;4721
6;515;37;2376;2509;4885
6;560;50;2371;2234;4605
6;371;50;2367;2420;4787
6;805;47;2366;2231;4597
6;840;33;2365;2505;4870
6;568;22;2359;2417;4776
6;760;8;2357;2571;4928
6;412;22;2356;2440;4796
6;756;19;2355;1988;4343
6;91;25;2353;2357;4710
6;35;38;2351;2453;4804
6;56;15;2350;2265;4615
6;252;3;2350;1948;4298
6;434;44;2349;2558;4907
6;840;0;2347;2213;4560
6;490;62;2346;3434;5780
6;434;58;2340;2813;5153
6;840;12;2340;2129;4469
6;560;48;2333;2188;4521
6;91;39;2332;2122;4454
6;760;6;2332;2163;4495
6;28;58;2331;2610;4941
6;91;31;2331;2676;5007
6;56;30;2331;2114;4445
6;434;52;2330;2772;5102
6;274;44;2328;2257;4585
6;756;30;2322;2373;4695
6;412;17;2322;2346;4668
6;760;7;2322;2162;4484
6;35;27;2320;2819;5139
6;638;26;2320;1961;4281
6;539;59;2318;2239;4557
6;357;70;2317;2848;5165
6;760;25;2316;2042;4358
6;56;2;2315;2094;4409
6;427;77;2313;3458;5771
6;539;54;2306;2363;4669
6;91;34;2306;2406;4712
6;35;4;2304;2259;4563
6;371;53;2301;2429;4730
6;760;32;2300;1750;4050
6;840;10;2299;2368;4667
6;840;13;2297;2026;4323
6;840;2;2296;2421;4717
6;840;37;2293;2493;4786
6;756;35;2290;2361;4651
6;840;16;2290;2427;4717
6;861;32;2289;2056;4345
6;756;23;2289;2598;4887
6;756;14;2289;1707;3996
6;760;0;2289;2634;4923
6;412;31;2288;2191;4479
6;28;57;2287;2535;4822
6;568;37;2287;1677;3964
6;638;30;2286;2666;4952
6;760;15;2286;2377;4663
6;427;78;2284;3206;5490
6;260;25;2283;2399;4682
6;252;2;2282;2159;4441
6;840;41;2279;2164;4443
6;840;39;2279;2578;4857
6;805;43;2278;2489;4767
6;412;30;2278;2282;4560
6;756;16;2276;1877;4153
6;412;23;2273;2314;4587
6;427;76;2270;3448;5718
6;568;51;2268;1822;4090
6;412;27;2268;2234;4502
6;56;4;2268;2348;4616
6;490;63;2267;2662;4929
6;638;35;2267;2083;4350
6;56;33;2266;2014;4280
6;35;26;2265;2462;4727
6;756;18;2265;2173;4438
6;760;9;2265;2251;4516
6;371;54;2264;2546;4810
6;840;42;2263;2191;4454
6;760;28;2261;2555;4816
6;568;31;2259;3191;5450
6;56;31;2258;2509;4767
6;840;36;2257;2444;4701
6;805;44;2256;2136;4392
6;490;70;2252;2424;4676
6;371;41;2252;2148;4400
6;805;42;2251;2545;4796
6;756;7;2246;1844;4090
6;568;38;2244;1793;4037
6;760;27;2241;2205;4446
6;638;33;2239;2367;4606
6;840;8;2237;2082;4319
6;441;65;2235;3071;5306
6;274;43;2235;1908;4143
6;515;40;2235;2245;4480
6;35;37;2231;2299;4530
6;28;59;2230;2627;4857
6;371;47;2230;2439;4669
6;441;66;2229;2670;4899
6;35;5;2228;2361;4589
6;35;36;2225;2376;4601
6;756;27;2225;2335;4560
6;412;26;2225;2100;4325
6;638;27;2224;2498;4722
6;252;10;2219;2018;4237
6;760;11;2214;2236;4450
6;756;9;2214;1969;4183
6;756;32;2213;2194;4407
6;35;17;2213;2307;4520
6;760;13;2213;2288;4501
6;260;26;2211;2739;4950
6;35;40;2209;2463;4672
6;756;37;2209;2044;4253
6;56;11;2209;2071;4280
6;56;27;2208;2274;4482
6;568;40;2207;2149;4356
6;91;36;2205;2215;4420
6;568;15;2205;2122;4327
6;56;6;2205;2016;4221
6;441;63;2203;2633;4836
6;539;58;2202;2358;4560
6;56;9;2201;2077;4278
6;568;39;2199;1932;4131
6;274;47;2194;2350;4544
6;35;13;2194;2276;4470
6;756;34;2193;2184;4377
6;260;33;2191;2097;4288
6;56;7;2189;1965;4154
6;56;32;2188;2311;4499
6;56;17;2187;1975;4162
6;658;65;2185;2475;4660
6;840;3;2184;2197;4381
6;840;1;2181;2347;4528
6;441;64;2179;2677;4856
6;56;5;2176;1824;4000
6;91;37;2174;2639;4813
6;56;35;2174;2141;4315
6;56;14;2174;1965;4139
6;91;38;2168;2041;4209
6;760;31;2167;2153;4320
6;260;40;2166;2246;4412
6;638;36;2166;2313;4479
6;805;48;2165;2133;4298
6;840;5;2165;2415;4580
6;568;36;2162;2773;4935
6;412;28;2157;2539;4696
6;412;29;2153;2048;4201
6;560;49;2152;1819;3971
6;252;18;2149;1793;3942
6;371;52;2148;2241;4389
6;274;46;2147;2054;4201
6;35;34;2144;2573;4717
6;412;24;2144;2476;4620
6;760;3;2144;2072;4216
6;371;45;2143;2222;4365
6;568;46;2142;1874;4016
6;56;12;2142;1983;4125
6;252;12;2141;1991;4132
6;35;42;2139;2174;4313
6;357;67;2138;3411;5549
6;861;29;2138;1862;4000
6;756;0;2136;1785;3921
6;638;39;2131;2020;4151
6;35;50;2130;1917;4047
6;756;40;2130;1785;3915
6;756;22;2129;2176;4305
6;260;37;2125;2250;4375
6;568;17;2124;1705;3829
6;56;34;2123;2303;4426
6;638;29;2123;2189;4312
6;412;25;2123;2132;4255
6;28;61;2120;2179;4299
6;638;32;2119;2443;4562
6;861;31;2117;2207;4324
6;252;1;2115;1993;4108
6;539;55;2113;2663;4776
6;434;59;2111;2669;4780
6;252;24;2109;1588;3697
6;434;56;2106;2940;5046
6;760;12;2106;2345;4451
6;568;16;2104;2458;4562
6;260;32;2102;2165;4267
6;490;65;2101;3263;5364
6;252;5;2101;2281;4382
6;568;63;2100;2081;4181
6;357;68;2095;3046;5141
6;371;60;2095;2816;4911
6;658;63;2088;2586;4674
6;260;36;2085;2562;4647
6;568;10;2085;1873;3958
6;371;46;2084;2445;4529
6;357;71;2082;2631;4713
6;56;8;2082;2283;4365
6;756;31;2081;2150;4231
6;274;50;2078;1611;3689
6;35;39;2075;2382;4457
6;760;37;2073;1917;3990
6;840;47;2072;2228;4300
6;760;26;2071;2171;4242
6;861;28;2064;1928;3992
6;260;38;2062;2086;4148
6;252;11;2062;1860;3922
6;568;53;2061;1663;3724
6;28;60;2060;2655;4715
6;515;39;2057;2197;4254
6;274;45;2053;2031;4084
6;260;35;2053;2532;4585
6;568;48;2052;2071;4123
6;441;68;2051;2292;4343
6;840;51;2050;1978;4028
6;840;55;2048;1935;3983
6;91;40;2044;2277;4321
6;805;46;2043;2231;4274
6;252;25;2042;1380;3422
6;490;64;2041;2793;4834
6;515;36;2038;2131;4169
6;260;34;2036;2218;4254
6;357;69;2034;2689;4723
6;260;41;2034;1948;3982
6;560;53;2031;1970;4001
6;515;38;2024;2075;4099
6;658;66;2019;2347;4366
6;434;62;2018;2551;4569
6;252;6;2018;1947;3965
6;252;13;2014;1983;3997
6;56;3;2012;2099;4111
6;252;8;2008;2008;4016
6;568;7;2008;2227;4235
6;560;58;2006;1541;3547
6;56;40;2004;1639;3643
6;412;33;2004;1960;3964
6;568;14;2004;2233;4237
6;515;41;2003;1714;3717
6;756;24;2003;2586;4589
6;539;61;1999;2088;4087
6;35;41;1999;2066;4065
6;756;28;1997;2301;4298
6;568;28;1995;2662;4657
6;638;38;1991;2230;4221
6;91;41;1990;2145;4135
6;568;29;1990;2817;4807
6;840;53;1989;2171;4160
6;252;9;1988;1945;3933
6;412;35;1987;1735;3722
6;35;52;1986;2109;4095
6;56;36;1986;2209;4195
6;861;26;1985;2051;4036
6;91;35;1982;2651;4633
6;560;51;1981;2068;4049
6;756;21;1981;2132;4113
6;56;13;1980;2252;4232
6;434;64;1979;2146;4125
6;756;29;1979;1951;3930
6;91;43;1978;1920;3898
6;756;25;1976;2332;4308
6;252;21;1976;1893;3869
6;840;58;1974;2024;3998
6;252;30;1971;2014;3985
6;412;38;1970;1533;3503
6;568;4;1970;2307;4277
6;861;20;1969;1905;3874
6;260;39;1967;2243;4210
6;371;49;1966;2867;4833
6;274;48;1966;2056;4022
6;56;37;1966;1828;3794
6;760;34;1963;2075;4038
6;805;50;1957;2008;3965
6;568;5;1957;1859;3816
6;756;10;1953;2012;3965
6;568;13;1952;2869;4821
6;560;46;1949;1903;3852
6;638;34;1949;2355;4304
6;568;42;1948;2195;4143
6;861;30;1946;2155;4101
6;252;22;1943;1955;3898
6;371;56;1941;2197;4138
6;252;15;1940;2211;4151
6;861;23;1935;1921;3856
6;658;64;1926;2474;4400
6;434;63;1926;2333;4259
6;756;46;1926;2039;3965
6;568;1;1926;2213;4139
6;756;43;1925;1654;3579
6;35;53;1923;1970;3893
6;568;2;1922;2109;4031
6;490;66;1919;2418;4337
6;861;24;1914;1912;3826
6;35;46;1913;2046;3959
6;861;27;1913;1819;3732
6;91;50;1912;1546;3458
6;568;41;1912;2193;4105
6;760;40;1912;1895;3807
6;756;6;1910;1682;3592
6;840;43;1908;1849;3757
6;252;0;1906;1946;3852
6;756;33;1902;2807;4709
6;861;40;1901;2081;3982
6;861;36;1901;2033;3934
6;35;45;1900;2184;4084
6;638;40;1900;2149;4049
6;840;50;1896;2158;4054
6;760;35;1896;2053;3949
6;756;8;1896;1653;3549
6;568;60;1895;1822;3717
6;760;36;1892;2027;3919
6;756;17;1891;2354;4245
6;560;52;1883;1895;3778
6;805;49;1882;2256;4138
6;840;49;1881;2101;3982
6;56;10;1880;1922;3802
6;638;42;1878;2014;3892
6;638;41;1878;1898;3776
6;805;53;1877;1764;3641
6;861;37;1876;1913;3789
6;252;29;1876;1696;3572
6;756;26;1876;1852;3728
6;756;13;1876;1750;3626
6;91;46;1874;1875;3749
6;252;7;1873;2072;3945
6;560;54;1872;2255;4127
6;28;62;1871;2366;4237
6;35;49;1871;1960;3831
6;805;55;1868;1493;3361
6;638;45;1865;1700;3565
6;56;39;1864;1768;3632
6;568;11;1864;1736;3600
6;861;33;1863;1966;3829
6;427;79;1861;2884;4745
6;35;58;1860;1752;3612
6;252;16;1860;1880;3740
6;270;11;1860;1625;3485
6;490;67;1859;2474;4333
6;756;39;1859;1949;3808
6;28;64;1856;1994;3850
6;35;55;1854;1930;3784
6;861;34;1853;2032;3885
6;539;63;1852;1767;3619
6;274;51;1849;2004;3853
6;568;8;1849;1701;3550
6;35;48;1848;1976;3824
6;515;46;1847;2042;3889
6;756;45;1847;2182;4029
6;252;31;1846;1951;3797
6;91;42;1844;1992;3836
6;56;46;1843;1706;3549
6;568;62;1840;1710;3550
6;515;42;1838;1902;3740
6;805;51;1837;1906;3743
6;252;20;1837;1913;3750
6;35;44;1836;2159;3995
6;56;49;1835;1929;3764
6;515;47;1832;1816;3648
6;760;38;1832;1990;3822
6;568;52;1831;2035;3866
6;840;56;1830;2295;4125
6;56;1;1827;2105;3932
6;861;19;1826;1665;3491
6;756;5;1825;2207;4032
6;441;67;1823;2331;4154
6;441;70;1821;2473;4294
6;539;60;1820;2525;4345
6;560;56;1819;1990;3809
6;252;4;1819;1982;3801
6;270;1;1816;1839;3655
6;91;48;1815;1715;3530
6;760;41;1807;1785;3592
6;756;49;1802;1959;3761
6;568;34;1797;2215;4012
6;252;19;1797;2126;3923
6;560;59;1794;1737;3531
6;568;45;1794;2036;3830
6;252;17;1792;1796;3588
6;861;25;1790;1843;3633
6;515;50;1787;1679;3466
6;35;47;1787;1962;3749
6;91;45;1787;1945;3732
6;371;58;1786;2449;4235
6;861;50;1786;2091;3877
6;274;56;1784;1749;3533
6;274;54;1782;1838;3620
6;840;46;1782;2071;3853
6;756;38;1781;1687;3468
6;490;68;1780;2111;3891
6;756;15;1776;1845;3621
6;274;49;1775;1930;3705
6;760;39;1775;1865;3640
6;760;33;1774;1933;3707
6;756;12;1774;2443;4217
6;515;45;1773;1877;3650
6;840;44;1773;2045;3818
6;56;38;1772;1974;3746
6;861;51;1769;1990;3759
6;756;3;1765;2138;3903
6;412;36;1763;1743;3506
6;260;47;1762;1750;3512
6;260;43;1761;1618;3379
6;560;63;1760;1912;3672
6;805;52;1760;1758;3518
6;56;45;1759;1754;3513
6;434;61;1758;2294;4052
6;756;11;1757;1631;3388
6;658;67;1755;2298;4053
6;35;60;1755;1944;3699
6;638;46;1754;1558;3312
6;260;42;1754;1700;3454
6;756;1;1753;1793;3546
6;861;18;1751;1669;3420
6;371;62;1748;2355;4103
6;274;52;1747;2144;3891
6;861;48;1746;1818;3564
6;270;0;1745;1455;3200
6;840;60;1742;2013;3755
6;252;33;1742;1866;3608
6;270;7;1742;1687;3429
6;568;50;1741;2090;3831
6;56;48;1739;1823;3562
6;756;2;1737;1833;3570
6;371;64;1736;1913;3649
6;56;47;1731;2058;3789
6;539;62;1730;1976;3706
6;270;10;1730;1590;3320
6;840;54;1723;2012;3735
6;35;43;1723;2264;3987
6;861;38;1723;1986;3709
6;56;54;1722;1494;3216
6;861;54;1720;1642;3362
6;270;14;1720;1598;3318
6;861;12;1718;1336;3054
6;840;45;1715;2253;3968
6;412;34;1714;1735;3449
6;749;0;1710;1322;3032
6;91;53;1709;1703;3412
6;756;36;1709;1870;3579
6;756;55;1707;1802;3509
6;638;49;1705;1440;3145
6;861;41;1705;1725;3430
6;560;55;1704;1849;3553
6;412;37;1704;1856;3560
6;441;69;1703;2000;3703
6;371;63;1700;1796;3496
6;35;51;1699;2036;3735
6;91;44;1698;1785;3483
6;260;50;1697;1498;3195
6;568;47;1693;1919;3612
6;756;51;1690;2066;3756
6;371;65;1687;1681;3368
6;756;57;1685;1539;3224
6;371;59;1683;1777;3460
6;861;35;1683;2231;3914
6;539;66;1681;1494;3175
6;260;48;1679;1551;3230
6;427;80;1678;3156;4834
6;756;47;1678;2047;3725
6;515;44;1678;2022;3700
6;91;47;1677;1670;3347
6;56;41;1672;1679;3351
6;861;49;1669;1838;3507
6;756;53;1668;1755;3423
6;270;2;1663;1544;3207
6;840;52;1661;1757;3418
6;861;43;1660;1711;3371
6;861;39;1660;1939;3599
6;412;39;1658;1650;3308
6;270;4;1657;1509;3166
6;274;55;1654;1844;3498
6;35;57;1653;2014;3667
6;840;48;1649;1892;3541
6;568;43;1646;2146;3792
6;568;55;1645;2188;3833
6;805;58;1644;1759;3403
6;490;71;1643;2172;3815
6;270;8;1642;1565;3207
6;371;51;1639;2468;4107
6;756;62;1637;1774;3411
6;252;36;1637;1562;3199
6;805;54;1636;1714;3350
6;539;65;1635;1771;3406
6;861;0;1635;1608;3243
6;861;15;1634;1607;3241
6;760;42;1633;1742;3375
6;749;25;1632;1211;2843
6;638;50;1628;1789;3417
6;434;65;1627;2314;3941
6;270;3;1624;1696;3320
6;861;16;1622;1249;2871
6;270;12;1621;1523;3144
6;568;3;1620;2520;4140
6;490;69;1618;2204;3822
6;35;54;1618;2440;4058
6;91;52;1617;1631;3248
6;252;28;1617;1576;3193
6;28;65;1616;1818;3434
6;560;60;1614;1967;3581
6;638;43;1614;1692;3306
6;861;47;1611;1721;3332
6;861;22;1611;1691;3302
6;408;18;1610;1579;3189
6;568;44;1608;1683;3291
6;560;57;1603;2030;3633
6;56;50;1602;1663;3265
6;270;22;1602;1417;3019
6;539;64;1601;1938;3539
6;760;45;1601;1525;3126
6;28;63;1600;1925;3525
6;658;68;1596;2136;3732
6;408;22;1595;1525;3120
6;252;26;1594;1511;3105
6;861;14;1594;1438;3032
6;861;17;1593;1773;3366
6;515;43;1592;1830;3422
6;270;13;1592;1561;3153
6;861;10;1589;1624;3213
6;408;4;1587;1363;2950
6;357;74;1586;2036;3622
6;760;51;1585;1409;2994
6;638;48;1584;1782;3366
6;270;23;1579;1437;3016
6;756;44;1578;1815;3393
6;861;5;1578;1808;3386
6;56;51;1577;1905;3482
6;56;43;1575;1974;3549
6;270;15;1575;1776;3351
6;568;57;1572;1773;3345
6;260;51;1571;1388;2959
6;638;44;1571;1756;3327
6;412;41;1571;1610;3181
6;560;65;1570;1425;2995
6;260;53;1570;1373;2943
6;568;56;1568;1697;3265
6;357;72;1566;2483;4049
6;270;5;1566;1521;3087
6;568;54;1565;1879;3444
6;408;7;1565;1160;2725
6;270;16;1564;1769;3333
6;756;56;1563;1609;3172
6;274;57;1562;1493;3055
6;756;48;1561;1627;3188
6;560;62;1558;1308;2866
6;260;45;1557;1433;2990
6;756;41;1556;2290;3846
6;638;47;1555;1580;3135
6;515;51;1554;1309;2863
6;56;44;1551;1972;3523
6;357;75;1550;2174;3724
6;371;66;1548;2078;3626
6;861;13;1548;1630;3178
6;274;59;1547;1500;3047
6;638;54;1545;1352;2897
6;861;9;1545;1692;3237
6;410;9;1545;1000;2545
6;371;67;1544;1924;3468
6;861;4;1543;1394;2937
6;840;57;1542;2042;3584
6;91;49;1541;1697;3238
6;805;60;1540;1640;3180
6;410;19;1540;1222;2762
6;252;27;1539;1570;3109
6;840;59;1534;1943;3477
6;274;53;1532;1879;3411
6;515;49;1531;1555;3086
6;760;43;1531;1674;3205
6;35;59;1529;2044;3573
6;270;20;1529;1694;3223
6;371;70;1525;1726;3251
6;427;81;1524;2687;4211
6;270;19;1524;1535;3059
6;252;40;1523;1684;3207
6;408;17;1523;1310;2833
6;861;53;1522;1827;3349
6;408;30;1522;1321;2843
6;749;20;1522;1480;3002
6;756;60;1521;1947;3468
6;861;42;1521;1599;3120
6;408;19;1521;1616;3137
6;861;60;1519;1954;3473
6;749;28;1519;1248;2767
6;270;24;1518;1623;3141
6;260;49;1515;1832;3347
6;434;67;1514;1707;3221
6;252;42;1514;1408;2922
6;408;33;1513;1471;2984
6;539;67;1511;1593;3104
6;371;61;1511;1980;3491
6;410;6;1511;1205;2716
6;434;68;1508;1856;3364
6;861;46;1507;1916;3423
6;410;23;1506;1328;2834
6;35;56;1502;2097;3599
6;56;57;1501;1553;3054
6;568;49;1501;2169;3670
6;861;2;1501;1373;2874
6;840;62;1500;1798;3298
6;861;52;1500;1891;3391
6;252;23;1499;1677;3176
6;274;60;1498;1616;3114
6;441;74;1497;1921;3418
6;270;17;1494;1571;3065
6;408;20;1493;1675;3168
6;270;18;1493;1296;2789
6;760;47;1491;1460;2951
6;35;62;1490;1782;3272
6;252;37;1490;1438;2928
6;861;3;1489;1531;3020
6;658;69;1485;1955;3440
6;861;66;1483;1281;2764
6;756;63;1483;1460;2943
6;658;70;1482;2124;3606
6;270;31;1481;1309;2790
6;270;9;1479;1748;3227
6;270;6;1479;1661;3140
6;441;72;1478;1945;3423
6;91;59;1478;1427;2905
6;270;21;1476;1331;2807
6;434;66;1475;2333;3808
6;56;55;1475;1827;3302
6;515;55;1472;1733;3205
6;252;39;1471;1751;3222
6;408;11;1471;1201;2672
6;434;71;1469;1938;3407
6;252;35;1469;1504;2973
6;861;55;1468;2056;3524
6;861;8;1466;1604;3070
6;840;65;1465;1859;3324
6;260;46;1465;1770;3235
6;408;26;1465;1466;2931
6;515;60;1463;1554;3017
6;756;52;1462;1735;3197
6;56;42;1462;1702;3164
6;35;61;1461;1750;3211
6;861;45;1458;1914;3372
6;270;29;1458;1431;2889
6;270;26;1457;1491;2948
6;568;58;1456;2166;3622
6;56;52;1456;1842;3298
6;408;14;1455;1273;2728
6;28;66;1454;2067;3521
6;35;65;1453;1647;3100
6;749;18;1453;1368;2821
6;270;28;1450;1432;2882
6;749;29;1449;1517;2966
6;805;57;1447;1657;3104
6;515;48;1443;1506;2949
6;252;32;1441;1615;3056
6;840;64;1440;1867;3307
6;408;25;1439;1404;2843
6;408;15;1439;1431;2870
6;91;51;1434;1761;3195
6;252;38;1434;1272;2706
6;408;21;1434;1611;3045
6;56;61;1433;1586;3019
6;568;70;1432;1699;3131
6;412;43;1431;1360;2791
6;756;66;1429;1770;3199
6;840;61;1429;1880;3309
6;515;52;1429;1517;2946
6;861;7;1429;1410;2839
6;515;57;1428;1599;3027
6;408;24;1428;1357;2785
6;408;23;1428;1162;2590
6;749;14;1427;1395;2822
6;408;9;1425;1495;2920
6;434;72;1423;2002;3425
6;756;59;1423;2093;3516
6;861;57;1419;1818;3237
6;749;23;1415;1247;2662
6;861;11;1411;1246;2657
6;28;67;1410;1835;3245
6;91;57;1410;1680;3090
6;861;56;1410;1882;3292
6;408;32;1410;1565;2975
6;410;31;1410;1404;2814
6;412;40;1409;1655;3064
6;749;4;1407;1253;2660
6;749;21;1406;1575;2981
6;763;33;1405;1244;2649
6;408;28;1399;1545;2944
6;408;1;1398;1366;2764
6;756;42;1396;1760;3156
6;805;56;1395;1645;3040
6;515;54;1395;1368;2763
6;410;21;1394;1313;2707
6;408;31;1393;1509;2902
6;408;2;1393;1470;2863
6;805;59;1392;1489;2881
6;638;52;1392;1344;2736
6;861;44;1392;1699;3091
6;260;44;1392;1469;2861
6;412;45;1391;1340;2731
6;270;30;1391;1495;2886
6;274;58;1390;1492;2882
6;861;1;1388;1456;2844
6;408;6;1385;1321;2706
6;91;58;1384;1632;3016
6;749;10;1383;1283;2666
6;410;40;1379;1371;2750
6;749;3;1378;1137;2515
6;760;46;1377;1475;2852
6;490;75;1376;1701;3077
6;861;6;1375;1503;2878
6;749;24;1374;1184;2558
6;434;70;1371;1938;3309
6;410;20;1371;1297;2668
6;441;71;1369;2036;3405
6;408;27;1367;1354;2721
6;658;71;1366;1792;3158
6;756;54;1365;1917;3282
6;760;44;1365;1925;3290
6;410;4;1365;1147;2512
6;252;34;1364;1503;2867
6;760;53;1363;1698;3061
6;749;15;1362;1368;2730
6;760;50;1359;1821;3180
6;408;29;1359;1474;2833
6;568;64;1358;1496;2854
6;840;63;1356;1976;3332
6;749;22;1356;1332;2688
6;441;73;1355;1849;3204
6;840;66;1355;1682;3037
6;270;25;1354;1176;2530
6;749;12;1354;1254;2608
6;568;59;1353;2625;3978
6;638;51;1351;1340;2691
6;270;35;1350;1366;2716
6;408;13;1350;1233;2583
6;408;12;1349;1403;2752
6;56;56;1344;1572;2916
6;756;58;1343;1902;3245
6;515;56;1342;1490;2832
6;861;59;1341;1790;3131
6;270;27;1341;1401;2742
6;410;17;1341;1112;2453
6;658;72;1340;1667;3007
6;408;35;1340;1033;2373
6;270;32;1338;1286;2624
6;749;6;1338;1304;2642
6;91;60;1337;1543;2880
6;861;62;1336;1852;3188
6;515;61;1336;1225;2561
6;805;61;1335;1246;2581
6;408;38;1335;1183;2518
6;408;40;1331;1181;2512
6;410;24;1330;1201;2531
6;260;56;1328;1293;2621
6;861;58;1327;1676;3003
6;763;1;1326;1094;2420
6;56;53;1325;1693;3018
6;91;61;1324;1340;2664
6;749;16;1322;1340;2662
6;763;14;1322;1150;2472
6;408;8;1322;1366;2688
6;861;64;1320;1640;2960
6;882;19;1320;1064;2384
6;749;2;1320;1317;2637
6;760;57;1318;1270;2588
6;252;41;1318;1499;2817
6;252;45;1317;1257;2574
6;410;14;1317;1432;2749
6;410;12;1316;1125;2441
6;749;33;1314;1307;2621
6;568;66;1312;1270;2582
6;410;35;1312;1096;2408
6;357;73;1311;2129;3440
6;434;75;1308;1771;3079
6;749;1;1308;1173;2481
6;35;63;1307;1702;3009
6;805;62;1307;1438;2745
6;408;0;1307;1353;2660
6;427;82;1306;2289;3595
6;274;63;1303;1133;2436
6;638;53;1303;1165;2468
6;408;5;1303;1628;2931
6;35;67;1301;1612;2913
6;270;34;1301;1292;2593
6;357;79;1299;1827;3126
6;357;78;1299;2076;3375
6;412;42;1299;1493;2792
6;412;47;1297;1268;2565
6;410;7;1297;1134;2431
6;568;61;1295;1700;2995
6;56;59;1295;1477;2772
6;260;57;1294;1170;2464
6;515;63;1293;1324;2617
6;252;44;1293;1006;2299
6;410;32;1292;1300;2592
6;861;63;1291;1439;2730
6;515;53;1291;1706;2997
6;91;54;1289;1567;2856
6;749;31;1289;1430;2719
6;410;30;1288;1196;2484
6;560;61;1285;1244;2529
6;410;16;1285;1085;2370
6;56;64;1283;1590;2873
6;749;11;1282;1086;2368
6;412;52;1280;1161;2441
6;490;73;1279;2089;3368
6;408;37;1279;1307;2586
6;91;55;1278;1624;2902
6;763;20;1277;1294;2571
6;260;58;1276;1267;2543
6;749;19;1276;1391;2667
6;749;17;1276;1104;2380
6;763;5;1276;1007;2283
6;490;72;1274;1827;3101
6;861;65;1273;1533;2806
6;515;58;1270;1396;2666
6;408;16;1270;1331;2601
6;749;7;1270;1349;2619
6;882;0;1270;943;2213
6;91;63;1268;1458;2726
6;412;53;1268;1244;2512
6;763;15;1267;1271;2538
6;756;50;1266;1774;3040
6;515;59;1265;1195;2460
6;410;10;1264;1249;2513
6;638;56;1258;977;2235
6;270;38;1257;1053;2310
6;434;69;1250;1926;3176
6;35;70;1249;1455;2704
6;760;56;1249;1430;2679
6;760;49;1249;1366;2615
6;357;76;1248;2109;3357
6;410;15;1248;1411;2659
6;56;62;1247;1369;2616
6;371;68;1246;1477;2723
6;763;30;1245;1394;2639
6;274;61;1244;1292;2536
6;412;44;1243;1579;2822
6;410;11;1243;1328;2571
6;412;50;1241;1415;2656
6;805;63;1239;1438;2677
6;861;61;1238;1793;3031
6;91;56;1238;1649;2887
6;749;8;1236;1116;2352
6;568;65;1235;2236;3471
6;56;60;1235;1715;2950
6;357;77;1234;1835;3069
6;371;69;1234;1269;2503
6;274;62;1233;1283;2516
6;260;54;1233;1410;2643
6;749;30;1232;1412;2644
6;410;18;1232;1432;2664
6;763;8;1228;1220;2448
6;410;27;1225;1174;2399
6;91;65;1222;1140;2362
6;410;5;1221;1167;2388
6;763;4;1217;1330;2547
6;28;69;1216;1546;2762
6;760;52;1216;1416;2632
6;260;52;1216;1570;2786
6;410;38;1216;1362;2578
6;410;8;1216;1102;2318
6;412;46;1215;1388;2603
6;658;73;1214;1635;2849
6;638;55;1213;1207;2420
6;412;51;1213;1260;2473
6;840;69;1212;1376;2588
6;412;48;1209;1497;2706
6;763;21;1206;1038;2244
6;658;74;1205;1551;2756
6;56;58;1205;1594;2799
6;270;40;1205;1139;2344
6;408;3;1205;1221;2426
6;760;60;1202;1376;2578
6;763;7;1201;1042;2243
6;412;59;1200;1003;2203
6;260;55;1199;1543;2742
6;410;13;1198;1111;2309
6;749;34;1197;1229;2426
6;763;25;1196;1347;2543
6;490;74;1195;1759;2954
6;749;40;1195;1183;2378
6;91;64;1194;1159;2353
6;270;33;1189;1267;2456
6;410;3;1187;1186;2373
6;410;26;1185;1151;2336
6;410;29;1183;1252;2435
6;490;77;1180;1678;2858
6;371;73;1180;1805;2985
6;35;64;1176;1666;2842
6;749;27;1176;1277;2453
6;749;13;1175;1272;2447
6;763;12;1174;1251;2425
6;410;25;1173;996;2169
6;763;9;1172;1345;2517
6;434;73;1171;1675;2846
6;252;47;1170;1374;2544
6;749;9;1169;1291;2460
6;412;55;1167;1148;2315
6;763;17;1167;957;2124
6;441;75;1166;2055;3221
6;749;5;1166;1199;2365
6;410;1;1165;1366;2531
6;410;39;1163;1089;2252
6;270;36;1163;1270;2433
6;763;2;1162;1125;2287
6;408;10;1161;1524;2685
6;490;76;1159;1552;2711
6;749;41;1158;1108;2266
6;410;22;1156;1378;2534
6;763;6;1156;1042;2198
6;410;0;1156;1067;2223
6;490;79;1152;1491;2643
6;410;47;1152;1117;2269
6;749;38;1151;993;2144
6;28;68;1150;1641;2791
6;749;35;1150;1248;2398
6;412;58;1148;1121;2269
6;791;6;1148;931;2079
6;840;70;1147;1803;2950
6;763;0;1147;1101;2248
6;56;63;1146;1396;2542
6;763;16;1146;1147;2293
6;364;0;1146;951;2097
6;648;5;1144;826;1970
6;763;24;1143;1137;2280
6;539;68;1142;1490;2632
6;260;59;1140;1263;2403
6;371;72;1139;1324;2463
6;28;70;1139;1632;2771
6;270;39;1138;951;2089
6;760;55;1136;1395;2531
6;35;69;1135;1401;2536
6;840;68;1134;1502;2636
6;756;70;1133;1303;2436
6;749;32;1130;1292;2422
6;882;2;1129;961;2090
6;410;2;1127;1101;2228
6;756;61;1126;1795;2921
6;412;49;1126;1291;2417
6;749;26;1125;1313;2438
6;760;48;1123;1643;2766
6;91;62;1121;1334;2455
6;410;28;1121;1305;2426
6;568;79;1120;960;2080
6;28;71;1120;1708;2828
6;252;53;1120;1009;2129
6;763;19;1120;874;1994
6;882;4;1118;1121;2239
6;763;26;1116;1102;2218
6;763;32;1114;1284;2398
6;371;71;1112;1672;2784
6;434;78;1111;1601;2712
6;252;49;1111;965;2076
6;791;18;1111;1025;2136
6;756;68;1108;1088;2196
6;56;65;1108;1442;2550
6;756;64;1107;1893;3000
6;410;37;1107;1297;2404
6;805;64;1106;1516;2622
6;756;65;1105;1376;2481
6;763;18;1104;1349;2453
6;56;66;1100;1369;2469
6;763;22;1100;1059;2159
6;408;42;1098;1023;2121
6;410;44;1097;996;2093
6;252;52;1094;1022;2116
6;410;42;1094;987;2081
6;410;41;1094;1431;2525
6;882;31;1094;846;1940
6;91;66;1093;1109;2202
6;515;62;1093;1363;2456
6;539;70;1092;1511;2603
6;882;16;1092;1018;2110
6;763;10;1092;1120;2212
6;658;75;1091;1627;2718
6;861;68;1091;1345;2436
6;568;67;1090;1638;2728
6;410;33;1086;1360;2446
6;882;14;1085;781;1866
6;515;65;1082;1167;2249
6;638;57;1082;1132;2214
6;791;23;1082;870;1952
6;840;67;1081;1467;2548
6;260;62;1080;1044;2124
6;408;44;1080;1040;2120
6;595;20;1079;741;1820
6;441;77;1078;1830;2908
6;805;65;1076;1452;2528
6;274;65;1076;1369;2445
6;763;29;1073;1073;2146
6;560;64;1072;1229;2301
6;882;11;1072;1014;2086
6;763;3;1072;1081;2153
6;412;54;1071;1097;2168
6;760;54;1069;1343;2412
6;410;48;1069;833;1902
6;882;21;1068;813;1881
6;260;60;1067;1458;2525
6;791;19;1067;1188;2255
6;270;37;1064;1074;2138
6;56;69;1063;1107;2170
6;760;61;1062;1133;2195
6;763;36;1062;1010;2072
6;252;46;1060;1037;2097
6;763;11;1060;1060;2120
6;35;66;1058;1610;2668
6;412;60;1054;1180;2234
6;791;10;1052;964;2016
6;441;76;1050;1728;2778
6;410;50;1050;1076;2126
6;763;27;1049;1143;2192
6;763;38;1048;930;1978
6;91;67;1046;1242;2288
6;805;67;1045;1027;2072
6;760;59;1045;1328;2373
6;410;45;1045;960;2005
6;882;20;1045;1071;2116
6;568;71;1044;1499;2543
6;623;6;1044;1043;2087
6;756;67;1043;1263;2306
6;252;43;1043;1373;2416
6;763;28;1043;1223;2266
6;791;3;1043;799;1842
6;427;83;1042;2293;3335
6;28;75;1042;1259;2301
6;427;84;1041;1986;3027
6;539;69;1041;1406;2447
6;412;57;1041;1134;2175
6;623;13;1041;581;1622
6;412;56;1040;1136;2176
6;791;30;1038;982;2020
6;791;24;1038;1035;2073
6;595;12;1038;978;2016
6;791;12;1037;839;1876
6;515;64;1036;1205;2241
6;252;50;1036;1202;2238
6;791;31;1036;824;1860
6;791;20;1036;1017;2053
6;252;51;1035;1053;2088
6;763;31;1035;927;1962
6;595;19;1033;858;1891
6;408;34;1032;1295;2327
6;791;21;1032;949;1981
6;763;23;1030;1150;2180
6;658;79;1027;1427;2454
6;638;58;1026;1127;2153
6;408;46;1026;1079;2105
6;371;75;1025;1184;2209
6;648;1;1024;1100;2124
6;763;13;1023;1013;2036
6;274;66;1021;1198;2219
6;749;45;1021;948;1969
6;434;76;1020;1827;2847
6;260;64;1020;1160;2180
6;408;36;1020;1250;2270
6;882;27;1018;930;1948
6;410;34;1017;1280;2297
6;357;80;1014;2141;3155
6;568;68;1014;1253;2267
6;408;51;1014;1021;2035
6;408;43;1013;1114;2127
6;749;36;1012;966;1978
6;763;35;1012;957;1969
6;56;70;1011;1341;2352
6;364;18;1011;734;1745
6;441;79;1005;1658;2663
6;882;18;1004;1079;2083
6;791;15;1004;840;1844
6;560;68;1003;1157;2160
6;56;68;1003;1204;2207
6;28;73;1001;1378;2379
6;270;45;1001;862;1863
6;658;76;1000;1760;2760
6;126;21;1000;757;1757
6;270;42;999;1028;2027
6;648;10;999;1140;2139
6;861;70;997;1343;2340
6;791;29;997;960;1957
6;434;77;996;1514;2510
6;882;32;996;806;1802
6;497;19;995;947;1942
6;749;50;994;875;1869
6;410;36;993;1267;2260
6;35;71;992;1279;2271
6;260;61;992;824;1816
6;623;8;992;759;1751
6;760;62;990;1453;2443
6;638;63;989;786;1775
6;840;72;988;1383;2371
6;648;2;988;890;1878
6;760;63;987;1291;2278
6;410;49;987;1052;2039
6;623;39;986;781;1767
6;595;14;986;850;1836
6;882;22;985;853;1838
6;560;71;984;731;1715
6;658;80;983;1465;2448
6;648;0;983;733;1716
6;357;81;982;1618;2600
6;763;34;982;958;1940
6;791;33;982;982;1964
6;539;72;981;1103;2084
6;408;55;981;1094;2075
6;749;39;980;922;1902
6;791;36;978;879;1857
6;882;8;978;1152;2130
6;364;2;977;913;1890
6;760;65;976;1072;2048
6;760;64;976;952;1928
6;749;37;976;997;1973
6;882;9;976;888;1864
6;791;9;972;1003;1975
6;408;39;971;1262;2233
6;882;1;971;877;1848
6;408;45;970;1168;2138
6;763;39;970;820;1790
6;364;4;970;872;1842
6;882;3;970;906;1876
6;270;41;969;915;1884
6;791;22;969;912;1881
6;497;5;969;837;1806
6;560;66;968;972;1940
6;791;28;968;882;1850
6;497;10;968;945;1913
6;497;31;967;739;1706
6;648;9;967;743;1710
6;364;9;967;909;1876
6;595;8;966;931;1897
6;882;15;965;874;1839
6;595;15;965;995;1960
6;861;67;963;1246;2209
6;805;66;962;1159;2121
6;623;14;962;751;1713
6;595;13;959;808;1767
6;408;41;958;1230;2188
6;568;74;957;1068;2025
6;791;35;957;1077;2034
6;560;70;956;849;1805
6;126;15;954;1005;1959
6;270;44;952;890;1842
6;595;28;952;739;1691
6;595;18;952;770;1722
6;882;5;952;973;1925
6;441;78;951;1723;2674
6;756;73;951;1211;2162
6;763;40;951;809;1760
6;791;14;951;968;1919
6;791;5;951;875;1826
6;497;37;950;812;1762
6;882;7;949;959;1908
6;861;75;948;1173;2121
6;274;64;948;1015;1963
6;408;58;948;976;1924
6;364;5;947;946;1893
6;427;85;945;1778;2723
6;56;67;944;1522;2466
6;410;54;943;996;1939
6;252;48;943;1132;2075
6;515;67;942;892;1834
6;763;49;942;702;1644
6;840;74;941;1165;2106
6;648;6;939;731;1670
6;760;58;937;1168;2105
6;763;45;937;892;1829
6;497;4;937;814;1751
6;623;17;936;653;1589
6;434;79;935;1608;2543
6;515;66;935;1022;1957
6;623;51;935;465;1400
6;497;18;935;876;1811
6;434;74;934;1572;2506
6;882;28;933;1030;1963
6;882;17;933;852;1785
6;658;77;931;1620;2551
6;791;1;928;776;1704
6;648;3;927;1004;1931
6;56;71;925;1047;1972
6;364;7;925;903;1828
6;791;2;925;821;1746
6;371;81;924;1275;2199
6;497;11;923;765;1688
6;490;78;922;1689;2611
6;497;30;922;833;1755
6;497;2;922;771;1693
6;252;58;919;1110;2029
6;408;57;919;1034;1953
6;408;53;918;847;1765
6;882;30;918;867;1785
6;98;30;918;836;1754
6;882;37;917;679;1596
6;595;33;916;631;1547
6;595;16;916;797;1713
6;408;47;915;1233;2148
6;791;13;915;920;1835
6;126;29;914;652;1566
6;28;74;913;1190;2103
6;539;71;912;1254;2166
6;882;25;912;866;1778
6;560;69;911;1246;2157
6;412;65;911;926;1837
6;252;56;911;692;1603
6;408;50;908;1183;2091
6;749;46;908;1002;1910
6;126;9;908;843;1751
6;371;76;907;1182;2089
6;840;71;907;1240;2147
6;98;5;907;711;1618
6;260;63;906;945;1851
6;882;10;905;1126;2031
6;410;46;904;1167;2071
6;791;38;904;786;1690
6;595;29;903;835;1738
6;595;1;903;845;1748
6;497;1;903;947;1850
6;126;0;902;867;1769
6;882;12;901;1029;1930
6;791;0;901;928;1829
6;364;11;899;774;1673
6;882;13;897;961;1858
6;410;59;896;914;1810
6;749;53;896;928;1824
6;581;9;896;820;1716
6;497;7;896;834;1730
6;497;13;894;793;1687
6;364;10;894;832;1726
6;408;48;893;1179;2072
6;408;54;892;1028;1920
6;252;54;892;958;1850
6;126;32;892;731;1623
6;497;20;892;859;1751
6;568;75;891;1201;2092
6;861;69;891;1283;2174
6;791;34;890;929;1819
6;791;8;890;948;1838
6;595;0;890;767;1657
6;791;4;889;854;1743
6;763;37;888;903;1791
6;364;17;888;591;1479
6;595;10;888;817;1705
6;408;56;886;1068;1954
6;497;16;886;897;1783
6;497;6;886;886;1772
6;364;1;886;898;1784
6;434;80;884;1644;2528
6;791;25;884;1068;1952
6;595;21;884;632;1516
6;882;6;884;1195;2079
6;35;68;883;1457;2340
6;410;43;883;963;1846
6;595;3;883;880;1763
6;623;1;883;1269;2152
6;91;69;881;1085;1966
6;749;48;881;1005;1886
6;364;14;881;884;1765
6;274;70;878;1001;1879
6;497;29;877;834;1711
6;497;12;877;775;1652
6;497;0;877;652;1529
6;756;71;876;1202;2078
6;595;11;876;870;1746
6;126;1;876;858;1734
6;595;4;875;876;1751
6;840;75;874;1387;2261
6;623;16;873;988;1861
6;648;7;873;883;1756
6;490;80;872;1256;2128
6;638;59;872;1034;1906
6;658;78;871;1508;2379
6;260;65;871;862;1733
6;760;66;870;895;1765
6;791;32;870;982;1852
6;623;24;870;610;1480
6;274;68;869;959;1828
6;410;57;868;1150;2018
6;763;47;868;825;1693
6;749;47;868;1057;1925
6;749;44;868;1001;1869
6;648;14;868;809;1677
6;126;2;868;734;1602
6;749;43;867;1015;1882
6;648;12;867;722;1589
6;371;74;865;1477;2342
6;28;72;865;1296;2161
6;408;49;864;878;1742
6;648;4;864;840;1704
6;595;22;863;771;1634
6;497;14;863;882;1745
6;126;30;862;697;1559
6;595;7;862;940;1802
6;497;32;861;870;1731
6;364;19;861;798;1659
6;35;74;860;1274;2134
6;763;59;860;894;1754
6;270;49;860;852;1712
6;364;12;859;954;1813
6;497;9;858;677;1535
6;126;6;857;846;1703
6;274;69;856;793;1649
6;648;17;856;855;1711
6;364;3;856;912;1768
6;126;3;856;766;1622
6;638;60;855;1003;1858
6;882;33;855;874;1729
6;623;29;855;763;1618
6;497;15;854;770;1624
6;791;17;853;1044;1897
6;270;53;852;643;1495
6;623;25;852;714;1566
6;126;13;852;728;1580
6;98;23;851;837;1688
6;638;65;850;745;1595
6;35;72;849;1373;2222
6;126;10;849;695;1544
6;412;61;848;921;1769
6;408;61;848;834;1682
6;497;28;848;783;1631
6;749;42;847;1024;1871
6;648;19;846;807;1653
6;126;7;846;778;1624
6;595;6;846;907;1753
6;427;86;845;1400;2245
6;595;24;844;764;1608
6;126;23;843;729;1572
6;882;29;842;975;1817
6;126;24;841;804;1645
6;98;14;841;631;1472
6;126;12;841;899;1740
6;581;14;840;599;1439
6;98;0;840;608;1448
6;35;73;839;1343;2182
6;410;61;838;813;1651
6;805;69;837;910;1747
6;252;59;837;828;1665
6;91;70;836;887;1723
6;410;53;836;1011;1847
6;497;23;835;827;1662
6;497;22;834;908;1742
6;595;30;833;866;1699
6;623;15;832;1062;1894
6;595;2;832;796;1628
6;252;60;831;1093;1924
6;98;19;831;805;1636
6;623;30;830;570;1400
6;568;78;829;1240;2069
6;408;60;829;1024;1853
6;595;35;829;791;1620
6;648;15;829;697;1526
6;364;15;829;801;1630
6;861;76;828;1212;2040
6;357;82;827;1611;2438
6;805;71;827;815;1642
6;413;19;827;754;1581
6;364;8;827;770;1597
6;413;29;826;638;1464
6;413;21;826;569;1395
6;568;69;825;1360;2185
6;763;42;825;990;1815
6;364;16;825;836;1661
6;791;26;824;1013;1837
6;581;17;824;763;1587
6;413;4;823;530;1353
6;805;68;821;996;1817
6;560;67;821;1154;1975
6;270;48;821;714;1535
6;595;31;821;784;1605
6;410;58;820;991;1811
6;412;63;819;1019;1838
6;497;8;819;998;1817
6;413;6;819;724;1543
6;882;39;818;690;1508
6;364;6;818;885;1703
6;805;70;817;1094;1911
6;595;38;817;676;1493
6;581;15;817;807;1624
6;791;16;816;916;1732
6;539;73;814;1024;1838
6;760;68;814;823;1637
6;126;14;814;831;1645
6;882;26;813;762;1575
6;497;25;812;664;1476
6;412;62;811;1045;1856
6;763;52;811;673;1484
6;497;27;811;803;1614
6;408;63;810;897;1707
6;749;55;810;1038;1848
6;791;27;810;939;1749
6;98;24;809;644;1453
6;791;44;808;650;1458
6;595;17;808;800;1608
6;791;11;808;811;1619
6;749;52;807;963;1770
6;126;4;807;857;1664
6;410;52;806;902;1708
6;56;74;805;1111;1916
6;756;69;804;1383;2187
6;763;41;804;943;1747
6;840;80;803;1247;2050
6;756;72;803;1096;1899
6;623;12;801;870;1671
6;861;74;800;1097;1897
6;623;5;800;632;1432
6;648;11;798;780;1578
6;274;67;797;1051;1848
6;791;39;797;661;1458
6;595;25;797;692;1489
6;840;73;796;1316;2112
6;515;69;796;811;1607
6;126;26;796;738;1534
6;497;24;796;862;1658
6;791;7;796;926;1722
6;126;22;795;710;1505
6;126;5;794;945;1739
6;763;56;793;784;1577
6;126;18;792;813;1605
6;408;52;791;952;1743
6;98;31;791;610;1401
6;595;5;791;847;1638
6;371;77;788;1346;2134
6;270;43;788;747;1535
6;648;16;788;748;1536
6;497;3;788;866;1654
6;861;72;787;1274;2061
6;410;62;787;845;1632
6;882;24;787;946;1733
6;648;8;787;717;1504
6;98;17;786;799;1585
6;581;8;786;639;1425
6;441;81;785;1517;2302
6;623;22;785;526;1311
6;252;55;784;811;1595
6;882;36;784;838;1622
6;35;75;781;1625;2406
6;408;62;780;1054;1834
6;364;24;780;735;1515
6;638;61;778;1009;1787
6;623;45;778;687;1465
6;595;9;778;816;1594
6;408;64;777;737;1514
6;126;11;777;979;1756
6;763;43;776;938;1714
6;623;36;776;746;1522
6;595;32;776;795;1571
6;882;23;776;843;1619
6;441;80;774;1559;2333
6;763;61;773;885;1658
6;623;18;771;738;1509
6;595;45;770;608;1378
6;413;28;770;758;1528
6;126;19;770;707;1477
6;98;37;769;520;1289
6;595;36;769;664;1433
6;581;7;769;766;1535
6;581;6;769;765;1534
6;749;60;768;906;1674
6;126;37;768;730;1498
6;126;17;768;608;1376
6;364;28;767;821;1588
6;623;20;767;1100;1867
6;840;78;766;1243;2009
6;260;66;766;833;1599
6;623;4;764;578;1342
6;805;72;763;883;1646
6;749;57;763;802;1565
6;98;7;763;711;1474
6;760;67;762;847;1609
6;126;28;762;724;1486
6;126;16;762;736;1498
6;763;51;761;703;1464
6;364;22;761;749;1510
6;763;54;760;826;1586
6;497;17;759;879;1638
6;595;26;758;734;1492
6;497;26;758;743;1501
6;98;6;756;860;1616
6;595;23;754;854;1608
6;497;33;753;915;1668
6;763;50;752;965;1717
6;497;47;752;723;1475
6;497;40;752;676;1428
6;371;79;751;1415;2166
6;98;18;751;804;1555
6;882;35;750;787;1537
6;364;23;750;759;1509
6;364;13;750;660;1410
6;791;41;748;919;1667
6;497;35;748;688;1436
6;364;32;748;648;1396
6;623;21;747;549;1296
6;581;4;747;748;1495
6;413;2;746;694;1440
6;861;73;745;1121;1866
6;270;51;745;801;1546
6;648;28;745;647;1392
6;98;32;744;724;1468
6;126;8;744;867;1611
6;413;0;744;572;1316
6;98;9;743;669;1412
6;749;49;742;835;1577
6;581;10;742;831;1573
6;126;27;741;752;1493
6;35;76;740;1082;1822
6;648;20;740;690;1430
6;357;85;739;1165;1904
6;357;83;738;1786;2524
6;408;59;737;995;1732
6;252;57;737;859;1596
6;410;55;737;1018;1755
6;763;44;737;944;1681
6;413;26;737;562;1299
6;357;84;736;1318;2054
6;35;78;736;1264;2000
6;56;72;736;958;1694
6;763;46;736;839;1575
6;364;30;736;667;1403
6;408;67;735;735;1470
6;581;12;735;783;1518
6;490;81;734;1207;1941
6;791;49;734;565;1299
6;595;47;734;758;1492
6;648;31;733;684;1417
6;408;66;732;766;1498
6;98;21;732;548;1280
6;623;7;732;742;1474
6;126;25;731;640;1371
6;648;13;731;980;1711
6;581;1;731;759;1490
6;568;73;729;1286;2015
6;413;16;728;619;1347
6;413;10;728;731;1459
6;749;58;726;892;1618
6;648;24;726;716;1442
6;623;37;725;695;1420
6;525;20;725;493;1218
6;861;77;724;1000;1724
6;791;51;723;631;1354
6;581;19;722;613;1335
6;28;78;721;1011;1732
6;413;24;721;504;1225
6;98;2;721;728;1449
6;840;77;720;1390;2110
6;497;44;720;694;1414
6;791;37;720;749;1469
6;497;34;720;746;1466
6;763;58;719;741;1460
6;623;56;719;555;1274
6;595;34;719;839;1558
6;595;39;718;616;1334
6;413;17;718;668;1386
6;371;80;717;1255;1972
6;270;58;717;569;1286
6;882;38;717;736;1453
6;515;68;716;985;1701
6;497;21;715;838;1553
6;623;11;714;797;1511
6;490;82;713;1222;1935
6;126;38;713;499;1212
6;791;40;712;937;1649
6;648;34;712;614;1326
6;98;13;712;781;1493
6;840;79;711;1139;1850
6;623;19;711;975;1686
6;791;48;710;771;1481
6;427;87;709;1371;2080
6;497;48;708;660;1368
6;98;12;708;824;1532
6;412;64;707;751;1458
6;763;48;707;1019;1726
6;126;20;707;776;1483
6;756;84;706;1140;1846
6;861;78;706;1103;1809
6;623;2;706;757;1463
6;408;65;703;849;1552
6;413;20;703;818;1521
6;749;62;702;609;1311
6;595;42;702;619;1321
6;413;25;702;663;1365
6;623;3;701;843;1544
6;568;72;700;1512;2212
6;648;26;699;791;1490
6;98;8;699;650;1349
6;840;76;698;1194;1892
6;882;40;698;735;1433
6;882;34;698;807;1505
6;623;10;698;704;1402
6;568;80;696;1101;1797
6;270;46;696;913;1609
6;882;44;696;697;1393
6;413;36;696;445;1141
6;756;78;695;978;1673
6;497;39;695;689;1384
6;364;25;694;642;1336
6;497;52;693;516;1209
6;648;23;693;869;1562
6;760;71;692;599;1291
6;595;37;692;824;1516
6;623;28;692;810;1502
6;581;13;692;677;1369
6;270;57;691;631;1322
6;791;45;691;700;1391
6;623;33;691;1047;1738
6;648;25;691;587;1278
6;441;82;690;1495;2185
6;252;62;689;713;1402
6;638;62;688;759;1447
6;749;54;688;961;1649
6;91;71;687;968;1655
6;126;41;687;567;1254
6;98;15;687;851;1538
6;581;2;687;670;1357
6;760;69;686;869;1555
6;882;48;686;750;1436
6;364;33;686;743;1429
6;98;33;686;605;1291
6;434;82;685;1301;1986
6;270;47;685;819;1504
6;497;36;685;633;1318
6;56;73;684;912;1596
6;623;34;684;683;1367
6;56;75;683;1138;1821
6;270;50;683;781;1464
6;126;35;683;713;1396
6;525;19;683;500;1183
6;413;13;683;552;1235
6;364;29;682;829;1511
6;410;56;681;954;1635
6;412;66;679;729;1408
6;791;47;679;683;1362
6;371;78;678;1306;1984
6;763;55;678;851;1529
6;882;47;678;558;1236
6;581;33;678;622;1300
6;98;28;678;811;1489
6;98;10;678;673;1351
6;763;57;677;785;1462
6;791;46;677;759;1436
6;98;27;677;694;1371
6;364;20;677;957;1634
6;35;81;676;834;1510
6;274;71;676;666;1342
6;410;65;676;820;1496
6;410;60;676;1054;1730
6;410;51;676;1005;1681
6;182;14;676;458;1134
6;28;76;675;1067;1742
6;260;67;673;761;1434
6;270;55;673;587;1260
6;749;51;673;971;1644
6;882;50;673;767;1440
6;648;18;673;847;1520
6;49;5;672;475;1147
6;56;76;671;872;1543
6;595;49;671;555;1226
6;595;48;671;634;1305
6;756;74;670;1091;1761
6;56;79;669;808;1477
6;126;31;669;807;1476
6;413;18;669;566;1235
6;98;16;667;694;1361
6;413;15;667;770;1437
6;413;12;667;729;1396
6;224;6;667;461;1128
6;638;68;666;642;1308
6;581;18;666;891;1557
6;882;42;665;624;1289
6;126;33;664;697;1361
6;756;75;662;1063;1725
6;98;34;661;614;1275
6;648;30;661;710;1371
6;861;71;659;1274;1933
6;413;33;659;649;1308
6;581;25;659;485;1144
6;420;14;659;594;1253
6;595;27;657;703;1360
6;882;51;656;590;1246
6;581;20;656;651;1307
6;98;3;656;662;1318
6;791;60;655;772;1427
6;623;58;655;543;1198
6;441;84;652;1122;1774
6;410;63;652;861;1513
6;648;21;652;794;1446
6;861;79;651;1168;1819
6;412;70;651;437;1088
6;413;3;651;608;1259
6;882;41;650;641;1291
6;623;26;650;616;1266
6;434;81;649;1465;2114
6;623;9;649;683;1332
6;595;40;648;732;1380
6;623;23;648;775;1423
6;98;4;648;595;1243
6;245;1;647;448;1095
6;791;57;646;671;1317
6;497;38;646;636;1282
6;126;40;644;574;1218
6;658;83;643;1052;1695
6;805;73;643;667;1310
6;623;50;643;723;1366
6;532;7;642;468;1110
6;581;38;639;691;1330
6;648;22;639;646;1285
6;778;9;639;601;1240
6;413;58;638;378;1016
6;749;56;638;785;1423
6;413;31;638;565;1203
6;581;11;638;693;1331
6;595;44;637;665;1302
6;581;35;637;537;1174
6;245;24;637;441;1078
6;252;61;636;824;1460
6;98;11;636;854;1490
6;581;29;635;613;1248
6;252;63;634;525;1159
6;778;5;634;597;1231
6;98;1;634;749;1383
6;28;77;633;1078;1711
6;623;64;633;496;1129
6;413;59;633;505;1138
6;648;32;633;604;1237
6;581;31;633;766;1399
6;364;31;633;699;1332
6;749;59;632;732;1364
6;791;50;631;752;1383
6;35;77;629;1278;1907
6;364;27;629;733;1362
6;581;3;629;557;1186
6;274;72;627;722;1349
6;49;12;627;431;1058
6;770;14;626;567;1193
6;791;55;625;678;1303
6;595;41;625;705;1330
6;778;7;625;563;1188
6;581;24;624;589;1213
6;260;70;623;777;1400
6;126;39;623;771;1394
6;413;14;622;762;1384
6;413;35;621;586;1207
6;413;30;621;692;1313
6;413;22;621;606;1227
6;778;3;621;602;1223
6;882;45;620;611;1231
6;791;42;620;822;1442
6;581;21;620;598;1218
6;778;10;620;614;1234
6;410;64;619;875;1494
6;581;16;619;751;1370
6;778;12;619;565;1184
6;434;84;617;1148;1765
6;497;42;617;768;1385
6;364;21;617;671;1288
6;35;82;616;939;1555
6;413;32;616;886;1502
6;595;64;615;479;1094
6;126;44;615;534;1149
6;778;2;615;613;1228
6;581;5;614;760;1374
6;98;29;612;663;1275
6;420;16;612;548;1160
6;756;80;611;900;1511
6;408;68;611;708;1319
6;595;46;611;680;1291
6;182;5;611;615;1226
6;98;41;610;711;1321
6;581;23;609;645;1254
6;778;6;609;599;1208
6;581;0;609;534;1143
6;568;76;608;1066;1674
6;91;73;608;669;1277
6;638;67;608;616;1224
6;497;46;608;563;1171
6;364;35;608;651;1259
6;420;12;608;582;1190
6;623;42;607;764;1371
6;648;29;607;694;1301
6;252;66;606;458;1064
6;595;63;606;543;1149
6;270;54;606;879;1485
6;763;53;606;765;1371
6;364;36;606;515;1121
6;581;28;606;670;1276
6;532;22;606;442;1048
6;532;19;606;502;1108
6;760;70;605;815;1420
6;91;68;605;1038;1643
6;791;56;605;700;1305
6;595;50;605;665;1270
6;525;18;605;499;1104
6;581;42;604;597;1201
6;413;37;604;582;1186
6;98;20;604;759;1363
6;252;65;603;843;1446
6;252;64;603;766;1369
6;595;57;603;638;1241
6;778;1;603;595;1198
6;532;16;602;539;1141
6;98;45;600;597;1197
6;412;67;599;702;1301
6;413;53;599;523;1122
6;882;53;598;475;1073
6;126;42;598;508;1106
6;581;36;598;683;1281
6;778;4;598;645;1243
6;182;10;597;523;1120
6;532;8;597;469;1066
6;413;39;596;485;1081
6;98;25;596;805;1401
6;778;14;596;593;1189
6;420;10;596;580;1176
6;658;81;595;1213;1808
6;861;80;595;1179;1774
6;413;5;595;570;1165
6;532;23;594;365;959
6;413;11;594;629;1223
6;420;8;594;529;1123
6;270;61;593;383;976
6;595;54;593;686;1279
6;595;43;593;742;1335
6;525;2;593;559;1152
6;49;10;592;521;1113
6;182;15;591;426;1017
6;420;9;591;558;1149
6;778;8;591;558;1149
6;410;70;590;686;1276
6;182;22;589;491;1080
6;778;11;589;552;1141
6;581;46;588;657;1245
6;182;34;588;425;1013
6;413;27;588;610;1198
6;420;7;588;561;1149
6;623;65;586;642;1228
6;882;56;586;631;1217
6;126;50;586;536;1122
6;770;6;586;553;1139
6;560;73;585;1217;1802
6;364;40;585;500;1085
6;581;37;585;588;1173
6;778;18;585;557;1142
6;623;46;584;578;1162
6;98;40;584;533;1117
6;182;31;584;563;1147
6;420;13;584;563;1147
6;770;7;584;586;1170
6;763;64;583;651;1234
6;623;0;583;540;1123
6;441;83;582;1276;1858
6;882;52;582;637;1219
6;568;77;581;917;1498
6;532;26;581;485;1066
6;638;64;580;769;1349
6;778;0;580;649;1229
6;49;0;580;431;1011
6;581;52;579;524;1103
6;98;42;579;578;1157
6;882;60;578;454;1032
6;778;19;578;571;1149
6;413;9;578;608;1186
6;49;8;578;544;1122
6;56;78;577;791;1368
6;539;74;577;1178;1755
6;581;45;577;719;1296
6;126;47;576;628;1204
6;126;36;576;687;1263
6;658;82;575;1138;1713
6;623;49;575;744;1319
6;420;3;575;518;1093
6;245;30;574;497;1071
6;182;19;574;530;1104
6;252;68;573;483;1056
6;28;79;572;1175;1747
6;539;76;572;781;1353
6;515;76;572;593;1165
6;763;65;572;544;1116
6;364;26;572;644;1216
6;420;6;572;597;1169
6;560;79;571;459;1030
6;532;33;571;432;1003
6;98;36;570;515;1085
6;778;16;570;511;1081
6;420;15;570;585;1155
6;420;5;570;583;1153
6;126;43;569;460;1029
6;770;8;569;538;1107
6;525;21;568;478;1046
6;532;18;568;479;1047
6;532;6;568;562;1130
6;539;75;567;969;1536
6;882;58;567;468;1035
6;882;46;567;646;1213
6;413;34;567;617;1184
6;98;22;565;772;1337
6;410;67;564;639;1203
6;581;32;564;544;1108
6;410;66;563;695;1258
6;270;56;563;544;1107
6;182;25;563;400;963
6;525;16;563;449;1012
6;525;11;563;497;1060
6;270;60;562;566;1128
6;525;5;561;542;1103
6;805;74;560;802;1362
6;623;41;560;624;1184
6;778;17;560;534;1094
6;126;34;559;557;1116
6;778;15;559;600;1159
6;134;0;559;535;1094
6;410;71;558;609;1167
6;420;11;557;574;1131
6;182;11;557;587;1144
6;245;3;557;474;1031
6;623;35;555;633;1188
6;270;52;554;768;1322
6;648;35;554;552;1106
6;581;39;553;604;1157
6;420;2;553;500;1053
6;805;76;552;793;1345
6;91;75;552;691;1243
6;49;16;552;458;1010
6;770;12;552;543;1095
6;532;4;552;566;1118
6;791;59;551;670;1221
6;98;39;551;657;1208
6;224;8;551;507;1058
6;581;47;550;560;1110
6;581;55;549;509;1058
6;791;53;549;657;1206
6;770;17;549;515;1064
6;98;26;548;524;1072
6;581;27;547;533;1080
6;490;83;546;1017;1563
6;539;77;546;870;1416
6;270;59;546;544;1090
6;882;43;546;415;961
6;413;23;546;662;1208
6;770;18;546;529;1075
6;525;15;546;532;1078
6;420;0;546;527;1073
6;497;60;545;470;1015
6;413;42;545;535;1080
6;648;33;545;684;1229
6;525;4;545;550;1095
6;420;1;545;547;1092
6;560;75;544;495;1039
6;412;69;544;677;1221
6;364;37;544;546;1090
6;833;15;544;438;982
6;770;11;544;505;1049
6;525;10;544;504;1048
6;364;45;543;623;1166
6;581;22;543;636;1179
6;770;15;543;545;1088
6;245;11;543;503;1046
6;763;62;542;721;1263
6;791;43;542;777;1319
6;770;19;542;514;1056
6;420;17;542;579;1121
6;413;7;542;581;1123
6;515;74;541;637;1178
6;515;71;541;818;1359
6;412;68;541;686;1227
6;413;45;541;507;1048
6;763;60;540;624;1164
6;413;57;540;486;1026
6;595;56;540;489;1029
6;791;52;540;582;1122
6;525;1;540;572;1112
6;581;40;539;538;1077
6;778;13;539;597;1136
6;134;6;539;483;1022
6;245;19;538;419;957
6;134;18;538;450;988
6;770;10;538;561;1099
6;568;81;537;1282;1819
6;749;61;537;766;1303
6;49;17;537;611;1148
6;623;48;536;887;1423
6;49;32;536;494;1030
6;182;1;536;551;1087
6;763;63;535;688;1223
6;791;54;535;721;1256
6;182;6;535;555;1090
6;749;63;534;695;1229
6;126;52;534;509;1043
6;623;38;534;754;1288
6;182;23;534;544;1078
6;778;20;534;520;1054
6;420;4;534;529;1063
6;770;2;534;520;1054
6;623;40;533;859;1392
6;49;18;533;414;947
6;770;5;533;499;1032
6;749;64;532;735;1267
6;182;21;532;577;1109
6;532;10;532;540;1072
6;833;0;532;327;859
6;434;87;531;613;1144
6;760;73;531;679;1210
6;413;38;531;687;1218
6;525;12;531;486;1017
6;770;9;531;550;1081
6;224;3;531;446;977
6;515;75;530;695;1225
6;525;6;530;521;1051
6;770;4;530;506;1036
6;91;72;529;920;1449
6;497;55;529;469;998
6;497;41;529;585;1114
6;532;1;529;439;968
6;408;70;528;718;1246
6;595;58;528;587;1115
6;595;51;528;717;1245
6;525;14;528;524;1052
6;134;12;528;466;994
6;532;2;528;592;1120
6;245;0;528;591;1119
6;638;66;526;624;1150
6;791;58;526;606;1132
6;497;45;526;549;1075
6;525;13;526;483;1009
6;134;5;526;496;1022
6;134;1;526;497;1023
6;497;53;525;583;1108
6;98;48;525;418;943
6;532;20;525;549;1074
6;182;4;525;438;963
6;770;1;525;510;1035
6;581;51;524;616;1140
6;497;50;524;635;1159
6;581;34;524;537;1061
6;515;70;523;803;1326
6;791;63;523;587;1110
6;182;27;523;457;980
6;224;16;523;492;1015
6;882;57;522;540;1062
6;98;35;522;651;1173
6;623;31;522;623;1145
6;770;20;522;489;1011
6;224;7;522;427;949
6;134;2;521;457;978
6;763;69;520;543;1063
6;791;66;520;516;1036
6;833;39;520;313;833
6;581;30;520;806;1326
6;420;18;520;577;1097
6;441;85;519;1138;1657
6;861;82;519;1030;1549
6;595;52;519;655;1174
6;581;49;519;508;1027
6;182;13;519;369;888
6;134;7;519;484;1003
6;413;60;518;511;1029
6;224;38;518;350;868
6;49;13;518;513;1031
6;882;49;517;526;1043
6;532;27;517;526;1043
6;420;20;517;494;1011
6;182;20;517;534;1051
6;49;6;517;592;1109
6;364;49;516;363;879
6;49;29;516;482;998
6;49;19;516;484;1000
6;532;9;516;492;1008
6;49;7;516;392;908
6;245;5;516;481;997
6;760;72;515;629;1144
6;49;3;515;495;1010
6;413;40;514;574;1088
6;532;15;514;418;932
6;182;12;514;479;993
6;245;15;513;502;1015
6;245;14;513;498;1011
6;98;47;512;443;955
6;648;40;512;418;930
6;364;34;512;678;1190
6;581;26;512;695;1207
6;274;75;511;753;1264
6;260;68;511;701;1212
6;497;57;511;580;1091
6;648;39;511;549;1060
6;364;38;511;545;1056
6;420;19;511;510;1021
6;833;10;511;480;991
6;134;10;511;513;1024
6;245;7;511;545;1056
6;434;83;510;1053;1563
6;756;76;510;849;1359
6;413;61;510;550;1060
6;245;28;510;539;1049
6;648;27;510;681;1191
6;134;3;510;488;998
6;182;2;510;477;987
6;497;56;509;456;965
6;134;14;509;493;1002
6;532;0;509;393;902
6;756;77;508;1495;2003
6;413;46;508;513;1021
6;581;53;507;508;1015
6;497;43;507;643;1150
6;224;33;507;458;965
6;532;30;507;448;955
6;532;12;507;523;1030
6;245;9;507;462;969
6;805;78;506;595;1101
6;91;74;506;626;1132
6;245;4;506;436;942
6;49;1;506;520;1026
6;770;0;506;556;1062
6;126;54;505;516;1021
6;581;43;505;679;1184
6;532;35;505;402;907
6;623;32;505;493;998
6;770;16;505;523;1028
6;224;13;505;438;943
6;224;11;505;546;1051
6;413;8;505;688;1193
6;525;3;505;521;1026
6;791;65;504;630;1134
6;623;27;504;1248;1752
6;245;17;504;478;982
6;49;11;504;625;1129
6;525;0;504;542;1046
6;581;56;503;448;951
6;581;44;502;560;1062
6;49;34;502;446;948
6;420;21;502;478;980
6;49;14;502;605;1107
6;770;13;502;520;1022
6;861;81;501;1062;1563
6;623;70;501;349;850
6;497;54;501;468;969
6;126;51;501;439;940
6;182;37;501;539;1040
6;134;11;501;456;957
6;126;46;500;548;1048
6;35;80;499;1043;1542
6;595;60;499;685;1184
6;497;49;499;703;1202
6;126;48;499;516;1015
6;413;43;499;517;1016
6;532;24;499;481;980
6;770;3;499;534;1033
6;413;50;498;596;1094
6;778;22;498;467;965
6;770;21;498;429;927
6;581;50;497;553;1050
6;49;24;497;367;864
6;28;80;496;1151;1647
6;260;69;496;726;1222
6;525;9;496;487;983
6;525;8;496;481;977
6;525;7;496;475;971
6;532;5;496;480;976
6;623;53;495;489;984
6;648;45;495;545;1040
6;525;23;495;468;963
6;532;13;495;427;922
6;595;53;494;644;1138
6;224;18;494;400;894
6;413;47;493;483;976
6;364;44;493;467;960
6;420;37;493;450;943
6;778;30;493;493;986
6;581;60;492;508;1000
6;595;55;492;572;1064
6;98;54;492;493;985
6;525;17;492;518;1010
6;134;15;492;459;951
6;182;7;492;504;996
6;791;64;491;479;970
6;49;15;491;602;1093
6;648;41;490;355;845
6;833;16;490;373;863
6;245;10;490;555;1045
6;224;10;490;554;1044
6;182;32;489;437;926
6;525;31;489;391;880
6;560;72;488;575;1063
6;623;43;488;506;994
6;357;86;487;1230;1717
6;525;33;487;345;832
6;224;30;487;454;941
6;525;24;487;464;951
6;525;22;486;478;964
6;833;18;486;360;846
6;134;4;486;514;1000
6;441;86;485;1067;1552
6;882;59;485;546;1031
6;413;41;485;687;1172
6;49;33;485;536;1021
6;532;28;485;503;988
6;134;13;485;449;934
6;134;8;485;435;920
6;371;82;484;1171;1655
6;252;67;484;744;1228
6;581;62;484;535;1019
6;413;48;484;440;924
6;756;81;483;875;1358
6;224;15;483;474;957
6;833;11;483;404;887
6;260;75;482;577;1059
6;763;71;482;430;912
6;749;65;481;537;1018
6;581;41;481;471;952
6;49;30;481;497;978
6;274;73;480;588;1068
6;749;66;480;597;1077
6;882;54;480;573;1053
6;182;33;480;494;974
6;182;3;480;458;938
6;805;75;479;687;1166
6;595;66;479;400;879
6;623;63;479;456;935
6;497;61;479;505;984
6;35;79;478;974;1452
6;49;47;478;410;888
6;833;14;478;456;934
6;515;72;477;666;1143
6;525;30;476;422;898
6;28;82;475;706;1181
6;791;62;475;540;1015
6;623;47;475;778;1253
6;420;23;475;439;914
6;134;17;475;412;887
6;595;61;474;575;1049
6;245;8;474;386;860
6;568;83;473;831;1304
6;648;37;473;584;1057
6;182;35;473;530;1003
6;134;9;473;531;1004
6;182;0;473;514;987
6;638;69;472;511;983
6;581;48;472;547;1019
6;532;47;472;244;716
6;623;44;472;678;1150
6;434;85;471;803;1274
6;840;82;471;875;1346
6;408;69;471;623;1094
6;778;21;471;491;962
6;245;18;471;348;819
6;182;16;471;546;1017
6;791;72;470;356;826
6;778;33;470;489;959
6;833;13;470;374;844
6;595;71;469;430;899
6;532;17;469;544;1013
6;245;16;469;495;964
6;833;4;469;410;879
6;497;51;468;558;1026
6;224;34;468;469;937
6;371;83;467;779;1246
6;182;36;467;328;795
6;420;22;467;411;878
6;134;16;467;448;915
6;763;72;466;369;835
6;126;55;466;413;879
6;49;31;466;543;1009
6;420;31;465;525;990
6;420;28;465;457;922
6;182;24;465;410;875
6;763;73;464;532;996
6;581;58;464;422;886
6;882;55;464;472;936
6;778;25;464;483;947
6;861;83;463;936;1399
6;420;30;463;436;899
6;568;82;462;932;1394
6;756;79;462;937;1399
6;98;46;462;517;979
6;413;1;462;748;1210
6;525;27;461;405;866
6;245;25;461;348;809
6;833;38;460;355;815
6;532;36;460;376;836
6;134;19;460;466;926
6;833;8;460;353;813
6;224;2;460;467;927
6;840;83;459;851;1310
6;408;74;459;614;1073
6;408;72;459;540;999
6;595;67;459;534;993
6;595;65;459;443;902
6;770;33;459;467;926
6;525;26;459;424;883
6;49;21;459;357;816
6;245;13;459;483;942
6;224;9;459;380;839
6;539;81;458;664;1122
6;126;45;458;626;1084
6;778;28;458;518;976
6;770;28;458;430;888
6;126;53;457;437;894
6;364;55;456;248;704
6;182;38;456;300;756
6;778;24;456;463;919
6;840;81;455;835;1290
6;224;61;455;307;762
6;224;37;455;381;836
6;224;4;455;438;893
6;539;78;454;698;1152
6;410;75;454;569;1023
6;763;66;454;624;1078
6;224;19;454;595;1049
6;182;17;454;589;1043
6;515;78;453;527;980
6;408;71;453;621;1074
6;623;61;453;485;938
6;770;32;453;454;907
6;532;25;453;484;937
6;749;67;452;573;1025
6;224;1;452;383;835
6;98;44;451;538;989
6;525;28;451;441;892
6;49;9;451;402;853
6;861;84;450;828;1278
6;581;57;450;518;968
6;420;33;450;517;967
6;770;29;450;444;894
6;525;25;450;414;864
6;98;62;449;399;848
6;532;39;449;392;841
6;833;35;449;305;754
6;833;32;449;424;873
6;182;30;449;456;905
6;778;23;449;446;895
6;410;69;448;699;1147
6;245;29;448;318;766
6;756;89;447;332;779
6;35;83;447;753;1200
6;270;62;447;490;937
6;49;4;447;418;865
6;408;73;446;558;1004
6;581;63;446;363;809
6;364;42;446;512;958
6;805;79;445;456;901
6;410;68;445;605;1050
6;126;56;445;375;820
6;778;31;445;472;917
6;539;80;444;863;1307
6;56;77;444;1013;1457
6;515;73;444;716;1160
6;364;39;444;603;1047
6;525;34;444;376;820
6;49;20;444;379;823
6;252;71;443;484;927
6;770;31;443;422;865
6;98;60;442;380;822
6;413;44;442;531;973
6;778;32;442;481;923
6;49;25;442;365;807
6;245;23;442;519;961
6;182;8;442;448;890
6;497;66;441;386;827
6;98;43;441;475;916
6;420;38;441;478;919
6;532;34;441;474;915
6;224;5;441;501;942
6;274;74;440;534;974
6;98;64;440;298;738
6;778;27;440;424;864
6;833;19;440;365;805
6;840;84;439;932;1371
6;560;78;439;541;980
6;224;48;439;364;803
6;420;35;439;522;961
6;420;32;439;501;940
6;224;32;439;451;890
6;770;30;439;458;897
6;770;27;439;420;859
6;224;62;437;409;846
6;581;54;437;518;955
6;364;50;437;477;914
6;770;22;437;460;897
6;532;14;437;460;897
6;882;62;436;367;803
6;833;24;436;355;791
6;749;70;435;656;1091
6;126;49;434;490;924
6;420;40;433;443;876
6;420;29;433;464;897
6;364;60;432;311;743
6;420;24;432;482;914
6;134;20;432;433;865
6;224;0;432;520;952
6;441;87;431;983;1414
6;56;80;431;719;1150
6;763;67;431;544;975
6;98;57;431;338;769
6;224;44;431;364;795
6;595;62;430;587;1017
6;420;39;430;423;853
6;778;29;430;475;905
6;224;17;430;436;866
6;182;9;430;508;938
6;98;63;429;437;866
6;420;47;429;444;873
6;224;29;429;548;977
6;525;32;428;394;822
6;833;31;428;291;719
6;756;82;427;976;1403
6;412;73;427;487;914
6;638;70;427;623;1050
6;270;64;427;394;821
6;882;61;427;396;823
6;623;54;427;570;997
6;364;52;427;291;718
6;778;35;427;446;873
6;778;34;427;461;888
6;224;21;427;334;761
6;756;83;426;812;1238
6;245;52;426;259;685
6;532;41;426;343;769
6;525;29;426;412;838
6;770;24;426;504;930
6;532;11;426;555;981
6;49;2;426;517;943
6;410;74;425;581;1006
6;364;47;425;451;876
6;770;25;425;390;815
6;833;23;425;369;794
6;260;71;424;682;1106
6;497;65;424;453;877
6;224;55;424;319;743
6;224;50;424;426;850
6;134;30;424;451;875
6;532;21;424;391;815
6;833;17;424;477;901
6;588;14;424;403;827
6;588;12;424;378;802
6;28;81;423;1016;1439
6;760;74;423;585;1008
6;270;65;423;266;689
6;98;50;423;538;961
6;245;22;423;581;1004
6;49;41;422;418;840
6;770;35;422;421;843
6;778;26;422;432;854
6;420;26;422;394;816
6;224;26;422;318;740
6;364;43;421;368;789
6;134;31;421;450;871
6;560;74;420;624;1044
6;413;67;420;406;826
6;49;46;420;346;766
6;410;77;419;514;933
6;791;61;419;800;1219
6;364;41;419;564;983
6;134;28;419;419;838
6;134;23;419;370;789
6;833;12;419;481;900
6;497;64;418;469;887
6;49;35;418;441;859
6;763;74;417;533;950
6;539;79;416;781;1197
6;49;26;416;400;816
6;833;6;416;459;875
6;497;63;415;495;910
6;420;27;415;429;844
6;588;10;415;376;791
6;581;65;414;537;951
6;98;59;414;454;868
6;532;46;414;404;818
6;245;26;414;396;810
6;648;50;413;340;753
6;420;49;413;377;790
6;224;12;413;449;862
6;826;7;413;374;787
6;210;4;413;355;768
6;245;20;412;434;846
6;882;66;411;368;779
6;98;52;411;456;867
6;648;43;411;321;732
6;210;12;411;388;799
6;532;3;411;482;893
6;420;45;410;426;836
6;134;24;410;404;814
6;210;10;410;383;793
6;833;7;410;457;867
6;413;64;409;496;905
6;413;56;409;553;962
6;778;38;409;412;821
6;245;33;409;481;890
6;98;53;408;403;811
6;420;50;408;436;844
6;588;7;408;338;746
6;882;64;407;460;867
6;98;56;407;529;936
6;134;29;407;392;799
6;420;25;407;397;804
6;49;23;407;439;846
6;224;14;407;601;1008
6;581;73;406;389;795
6;623;57;406;505;911
6;364;53;406;343;749
6;833;27;406;268;674
6;410;72;405;487;892
6;595;59;405;560;965
6;648;36;405;597;1002
6;490;84;404;944;1348
6;778;40;404;407;811
6;49;36;404;334;738
6;134;27;404;361;765
6;126;59;403;313;716
6;648;46;403;456;859
6;245;35;403;334;737
6;245;34;403;430;833
6;427;88;402;1015;1417
6;658;85;402;843;1245
6;588;16;402;372;774
6;833;5;402;600;1002
6;420;34;401;461;862
6;134;25;401;439;840
6;412;75;400;445;845
6;182;46;400;407;807
6;833;9;400;323;723
6;260;73;399;485;884
6;364;56;399;366;765
6;778;39;399;383;782
6;210;11;399;410;809
6;588;4;399;365;764
6;412;71;398;514;912
6;252;69;398;367;765
6;532;58;398;278;676
6;49;39;398;408;806
6;778;36;398;408;806
6;245;21;398;358;756
6;588;9;398;401;799
6;357;87;397;977;1374
6;882;65;397;545;942
6;420;51;397;355;752
6;420;42;397;423;820
6;245;38;397;331;728
6;134;21;397;462;859
6;588;6;397;431;828
6;217;0;397;338;735
6;35;84;396;738;1134
6;497;67;396;547;943
6;126;60;396;516;912
6;648;53;396;363;759
6;833;34;396;412;808
6;134;22;396;391;787
6;371;84;395;838;1233
6;532;51;395;386;781
6;770;23;395;401;796
6;833;21;395;340;735
6;408;78;394;442;836
6;260;72;394;652;1046
6;217;5;394;362;756
6;833;54;393;338;731
6;49;22;393;470;863
6;525;35;392;345;737
6;826;11;392;383;775
6;490;85;391;818;1209
6;126;57;391;358;749
6;413;49;391;527;918
6;126;58;390;409;799
6;420;43;390;412;802
6;588;8;390;369;759
6;861;86;389;713;1102
6;56;81;389;988;1377
6;648;47;389;354;743
6;778;37;389;453;842
6;833;2;389;438;827
6;581;69;388;408;796
6;497;59;388;549;937
6;224;45;388;465;853
6;182;39;388;452;840
6;420;36;388;429;817
6;245;36;388;367;755
6;134;33;388;394;782
6;826;5;388;383;771
6;270;63;387;498;885
6;420;59;387;399;786
6;525;36;387;378;765
6;210;31;387;402;789
6;560;77;386;612;998
6;623;66;386;461;847
6;581;64;386;472;858
6;420;48;386;395;781
6;49;38;386;359;745
6;826;12;386;366;752
6;274;77;385;511;896
6;252;70;385;407;792
6;595;68;385;426;811
6;420;53;385;403;788
6;98;38;385;757;1142
6;826;6;385;375;760
6;581;67;384;462;846
6;623;55;384;663;1047
6;413;51;384;471;855
6;182;18;384;444;828
6;210;7;384;384;768
6;217;2;384;347;731
6;210;0;384;384;768
6;420;55;383;407;790
6;770;34;383;395;778
6;826;14;383;367;750
6;210;5;383;385;768
6;364;54;382;327;709
6;420;52;382;399;781
6;826;18;382;352;734
6;210;14;382;396;778
6;245;12;382;381;763
6;210;9;382;351;733
6;217;3;382;363;745
6;260;76;381;455;836
6;595;72;381;384;765
6;791;68;381;480;861
6;49;65;381;498;879
6;648;51;381;386;767
6;182;26;381;497;878
6;588;17;381;406;787
6;609;14;381;339;720
6;588;0;381;383;764
6;623;60;380;440;820
6;420;41;380;430;810
6;224;27;380;406;786
6;609;10;380;349;729
6;833;50;379;348;727
6;182;41;379;337;716
6;49;40;379;417;796
6;217;13;379;357;736
6;588;5;379;381;760
6;91;80;378;737;1115
6;791;71;378;467;845
6;420;54;378;407;785
6;532;40;378;390;768
6;648;38;378;629;1007
6;134;35;378;392;770
6;826;15;378;391;769
6;245;6;378;565;943
6;91;76;377;656;1033
6;638;74;377;360;737
6;420;61;377;380;757
6;581;59;377;524;901
6;525;40;377;322;699
6;770;38;377;352;729
6;469;12;377;333;710
6;826;10;377;385;762
6;280;7;377;349;726
6;427;89;376;960;1336
6;791;69;376;523;899
6;224;36;376;431;807
6;588;11;376;405;781
6;588;2;376;342;718
6;515;77;375;445;820
6;224;40;375;352;727
6;532;38;375;419;794
6;245;37;375;374;749
6;224;25;375;422;797
6;497;58;374;561;935
6;49;45;374;393;767
6;420;44;374;385;759
6;532;37;374;408;782
6;49;27;374;476;850
6;609;16;374;372;746
6;217;9;374;347;721
6;490;88;373;449;822
6;408;76;373;444;817
6;420;60;373;426;799
6;420;56;373;431;804
6;413;54;373;628;1001
6;648;49;373;346;719
6;420;46;373;411;784
6;770;26;373;393;766
6;217;19;373;365;738
6;217;10;373;351;724
6;588;3;373;353;726
6;760;77;371;506;877
6;182;48;371;444;815
6;224;31;371;533;904
6;588;18;371;378;749
6;63;18;371;355;726
6;112;17;371;261;632
6;588;13;371;361;732
6;791;74;370;392;762
6;749;71;370;536;906
6;833;46;370;374;744
6;245;31;370;457;827
6;224;22;370;468;838
6;63;10;370;330;700
6;826;9;370;385;755
6;760;75;369;600;969
6;224;41;369;372;741
6;833;20;369;390;759
6;210;16;369;369;738
6;210;13;369;361;730
6;56;82;368;627;995
6;763;75;368;468;836
6;245;49;368;247;615
6;210;32;368;361;729
6;182;29;368;606;974
6;469;15;368;329;697
6;217;8;368;320;688
6;210;6;368;362;730
6;91;78;367;524;891
6;98;49;367;421;788
6;833;48;367;290;657
6;833;47;367;406;773
6;134;32;367;395;762
6;469;17;367;277;644
6;749;69;366;668;1034
6;749;68;366;687;1053
6;126;61;366;410;776
6;224;58;366;297;663
6;49;57;366;444;810
6;648;44;366;261;627
6;91;79;365;497;862
6;805;77;365;846;1211
6;420;58;365;382;747
6;98;55;365;392;757
6;623;52;365;436;801
6;833;25;365;305;670
6;588;19;365;329;694
6;112;13;365;335;700
6;217;4;365;344;709
6;371;85;364;808;1172
6;749;73;364;390;754
6;791;70;364;460;824
6;420;57;364;408;772
6;182;54;364;335;699
6;49;37;364;419;783
6;210;19;364;343;707
6;210;17;364;356;720
6;217;1;364;319;683
6;49;54;363;350;713
6;833;45;363;445;808
6;833;29;363;418;781
6;63;23;363;307;670
6;63;13;363;342;705
6;280;10;363;355;718
6;112;10;363;292;655
6;210;3;363;351;714
6;126;65;362;282;644
6;413;63;362;421;783
6;623;59;362;916;1278
6;364;46;362;556;918
6;525;38;362;347;709
6;217;30;362;325;687
6;63;11;362;331;693
6;826;8;362;382;744
6;413;65;361;531;892
6;224;46;361;322;683
6;224;42;361;282;643
6;588;30;361;356;717
6;364;48;360;343;703
6;833;40;360;366;726
6;469;18;360;295;655
6;63;14;360;352;712
6;245;45;359;232;591
6;833;30;359;393;752
6;280;12;359;324;683
6;210;1;359;331;690
6;28;83;358;617;975
6;182;45;358;255;613
6;469;10;358;345;703
6;539;82;357;707;1064
6;252;75;357;335;692
6;638;72;357;403;760
6;245;51;357;271;628
6;134;37;357;350;707
6;210;30;357;404;761
6;588;15;357;408;765
6;826;2;357;321;678
6;581;70;356;456;812
6;245;41;356;365;721
6;224;28;356;422;778
6;134;26;356;392;748
6;280;9;356;305;661
6;217;6;356;373;729
6;412;72;355;627;982
6;791;67;355;581;936
6;270;66;355;432;787
6;833;42;355;326;681
6;224;39;355;390;745
6;210;35;355;328;683
6;469;5;355;343;698
6;91;77;354;627;981
6;410;73;354;453;807
6;182;40;354;363;717
6;63;22;354;334;688
6;182;47;353;300;653
6;210;33;353;375;728
6;112;14;353;296;649
6;609;12;353;338;691
6;280;6;353;332;685
6;568;84;352;845;1197
6;420;65;352;381;733
6;182;44;352;357;709
6;134;38;352;349;701
6;525;37;352;353;705
6;532;32;352;556;908
6;224;24;352;431;783
6;210;2;352;358;710
6;840;85;351;589;940
6;126;62;351;338;689
6;224;59;351;444;795
6;280;16;351;298;649
6;280;0;351;327;678
6;224;47;350;376;726
6;532;43;350;405;755
6;245;40;350;345;695
6;134;34;350;392;742
6;217;31;350;370;720
6;826;16;350;355;705
6;770;37;349;384;733
6;63;20;349;320;669
6;63;8;349;326;675
6;588;1;349;336;685
6;245;50;348;333;681
6;532;42;348;307;655
6;134;36;348;369;717
6;532;29;348;387;735
6;833;26;348;342;690
6;609;3;348;304;652
6;413;71;347;298;645
6;532;45;347;301;648
6;770;36;347;385;732
6;245;32;347;439;786
6;833;1;347;411;758
6;760;78;346;601;947
6;420;63;346;387;733
6;280;17;346;305;651
6;217;15;346;354;700
6;658;86;345;628;973
6;420;62;345;354;699
6;245;47;345;364;709
6;210;28;345;376;721
6;217;14;345;321;666
6;63;12;345;334;679
6;245;2;345;478;823
6;274;76;344;627;971
6;833;28;344;413;757
6;63;19;344;348;692
6;98;51;343;363;706
6;210;34;343;362;705
6;217;16;343;315;658
6;280;8;343;390;733
6;245;53;342;343;685
6;532;48;342;361;703
6;770;40;342;375;717
6;63;15;342;340;682
6;826;13;342;363;705
6;210;8;342;375;717
6;665;6;342;317;659
6;469;3;342;294;636
6;469;0;342;286;628
6;581;61;341;507;848
6;413;52;341;499;840
6;210;15;341;377;718
6;63;6;341;332;673
6;280;1;341;305;646
6;497;70;340;327;667
6;648;60;340;187;527
6;98;58;340;440;780
6;210;29;340;321;661
6;224;23;340;440;780
6;217;18;340;343;683
6;217;7;340;357;697
6;49;60;339;411;750
6;224;43;339;404;743
6;778;42;339;330;669
6;525;39;339;365;704
6;210;37;339;330;669
6;280;19;339;301;640
6;280;14;339;329;668
6;469;11;339;335;674
6;826;17;338;350;688
6;63;17;338;302;640
6;63;16;338;316;654
6;609;15;338;310;648
6;98;61;337;420;757
6;833;53;337;368;705
6;280;11;337;329;666
6;280;2;337;357;694
6;826;1;337;311;648
6;63;0;337;307;644
6;623;72;336;440;776
6;648;54;336;365;701
6;49;51;336;365;701
6;49;49;336;423;759
6;49;44;336;424;760
6;134;40;336;323;659
6;826;28;336;314;650
6;224;20;336;396;732
6;112;18;336;289;625
6;469;16;336;314;650
6;63;7;336;337;673
6;408;77;335;503;838
6;98;71;335;253;588
6;581;66;335;421;756
6;49;56;335;302;637
6;224;53;335;387;722
6;778;47;335;340;675
6;469;13;335;332;667
6;112;6;335;331;666
6;826;3;335;330;665
6;665;3;335;284;619
6;539;83;334;511;845
6;420;64;334;359;693
6;280;15;334;370;704
6;483;10;334;308;642
6;609;8;334;319;653
6;532;31;333;381;714
6;826;4;333;383;716
6;483;0;333;331;664
6;882;63;332;424;756
6;182;43;332;404;736
6;49;43;332;329;661
6;778;41;332;349;681
6;833;37;332;295;627
6;210;20;332;257;589
6;203;6;332;285;617
6;420;67;331;321;652
6;49;48;331;360;691
6;245;39;331;370;701
6;210;38;331;319;650
6;217;32;331;299;630
6;595;70;330;420;750
6;126;64;330;286;616
6;826;20;330;307;637
6;609;9;330;347;677
6;609;7;330;301;631
6;408;79;329;463;792
6;126;63;329;437;766
6;364;57;329;372;701
6;210;36;329;315;644
6;63;21;329;304;633
6;280;18;329;308;637
6;112;15;329;313;642
6;469;14;329;314;643
6;217;12;329;342;671
6;826;0;329;329;658
6;28;85;328;701;1029
6;749;72;328;511;839
6;638;71;328;568;896
6;763;68;328;597;925
6;588;36;328;298;626
6;217;11;328;348;676
6;63;4;328;289;617
6;805;80;327;678;1005
6;770;50;327;331;658
6;134;39;327;327;654
6;826;30;327;318;645
6;210;23;327;333;660
6;112;11;327;331;658
6;63;5;327;293;620
6;412;74;326;515;841
6;497;68;326;338;664
6;224;63;326;305;631
6;224;51;326;347;673
6;609;2;326;304;630
6;56;83;325;854;1179
6;763;70;325;590;915
6;49;58;325;361;686
6;770;52;325;281;606
6;770;39;325;332;657
6;217;17;325;315;640
6;203;14;325;298;623
6;112;8;325;324;649
6;609;1;325;330;655
6;882;68;324;389;713
6;623;62;324;526;850
6;245;59;324;309;633
6;49;59;324;368;692
6;778;45;324;323;647
6;49;28;324;422;746
6;63;24;324;321;645
6;217;20;324;315;639
6;210;18;324;364;688
6;609;11;324;304;628
6;490;86;323;655;978
6;224;56;323;281;604
6;854;7;323;298;621
6;280;5;323;340;663
6;357;89;322;655;977
6;581;75;322;339;661
6;595;74;322;372;694
6;833;57;322;262;584
6;826;31;322;307;629
6;210;22;322;309;631
6;469;8;322;297;619
6;609;6;322;331;653
6;749;74;321;439;760
6;532;55;321;389;710
6;245;55;321;394;715
6;525;43;321;293;614
6;63;32;321;291;612
6;826;29;321;296;617
6;875;17;321;326;647
6;203;16;321;330;651
6;357;88;320;930;1250
6;760;79;320;568;888
6;833;49;320;280;600
6;770;44;320;357;677
6;469;32;320;285;605
6;210;27;320;336;656
6;826;19;320;320;640
6;875;14;320;308;628
6;665;14;320;285;605
6;371;86;319;653;972
6;833;59;319;329;648
6;648;52;319;325;644
6;525;41;319;287;606
6;588;31;319;345;664
6;469;30;319;324;643
6;280;20;319;317;636
6;469;9;319;332;651
6;868;5;319;286;605
6;203;0;319;269;588
6;770;48;318;309;627
6;833;43;318;362;680
6;203;19;318;268;586
6;875;15;318;321;639
6;270;70;317;211;528
6;581;68;317;442;759
6;532;49;317;361;678
6;770;47;317;356;673
6;833;3;317;297;614
6;112;0;317;290;607
6;770;46;316;303;619
6;217;29;316;375;691
6;469;7;316;299;615
6;63;2;316;319;635
6;413;66;315;451;766
6;826;38;315;300;615
6;826;32;315;298;613
6;665;17;315;289;604
6;203;15;315;332;647
6;602;14;315;286;601
6;469;6;315;344;659
6;112;4;315;324;639
6;63;1;315;317;632
6;413;76;314;486;800
6;412;76;314;455;769
6;364;63;314;311;625
6;532;52;314;343;657
6;588;45;314;301;615
6;182;42;314;335;649
6;245;27;314;508;822
6;210;21;314;308;622
6;112;12;314;295;609
6;868;11;314;301;615
6;609;4;314;331;645
6;861;85;313;693;1006
6;791;73;313;527;840
6;49;64;313;302;615
6;364;61;313;267;580
6;49;42;313;398;711
6;588;33;313;318;631
6;112;16;313;360;673
6;854;11;313;286;599
6;483;6;313;299;612
6;28;84;312;572;884
6;420;66;312;346;658
6;826;35;312;354;666
6;469;19;312;315;627
6;112;9;312;285;597
6;826;33;311;294;605
6;588;28;311;316;627
6;217;21;311;292;603
6;665;19;311;268;579
6;203;18;311;264;575
6;70;14;311;252;563
6;609;5;311;334;645
6;49;67;310;263;573
6;224;65;310;444;754
6;182;50;310;285;595
6;588;35;310;334;644
6;224;35;310;463;773
6;868;10;310;244;554
6;70;9;310;272;582
6;483;7;310;334;644
6;756;85;309;639;948
6;49;50;309;362;671
6;224;49;309;402;711
6;245;46;309;225;534
6;217;33;309;313;622
6;609;17;309;312;621
6;609;13;309;305;614
6;203;10;309;274;583
6;469;2;309;302;611
6;112;2;308;305;613
6;749;75;307;650;957
6;252;73;307;473;780
6;364;51;307;411;718
6;182;51;307;391;698
6;134;42;307;296;603
6;826;39;307;310;617
6;210;25;307;289;596
6;854;19;307;288;595
6;112;19;307;314;621
6;112;7;307;316;623
6;63;3;307;301;608
6;665;1;307;287;594
6;840;86;306;695;1001
6;260;79;306;450;756
6;98;67;306;327;633
6;770;56;306;274;580
6;112;30;306;307;613
6;63;29;306;315;621
6;826;26;306;277;583
6;217;23;306;308;614
6;70;7;306;265;571
6;49;55;305;441;746
6;770;45;305;305;610
6;134;44;305;308;613
6;770;43;305;311;616
6;217;28;305;345;650
6;217;25;305;302;607
6;392;11;305;268;573
6;469;1;305;284;589
6;568;85;304;682;986
6;532;54;304;374;678
6;210;42;304;261;565
6;770;41;304;331;635
6;588;39;304;305;609
6;588;32;304;356;660
6;588;20;304;299;603
6;203;17;304;343;647
6;266;14;304;280;584
6;63;9;304;301;605
6;112;5;304;330;634
6;756;87;303;399;702
6;364;58;303;366;669
6;833;51;303;388;691
6;134;47;303;252;555
6;63;38;303;277;580
6;112;31;303;283;586
6;609;20;303;267;570
6;70;19;303;254;557
6;483;13;303;280;583
6;875;7;303;283;586
6;266;7;303;284;587
6;805;82;302;472;774
6;882;73;302;279;581
6;497;71;302;328;630
6;497;62;302;522;824
6;588;37;302;326;628
6;63;31;302;336;638
6;280;30;302;316;618
6;483;2;302;308;610
6;112;1;302;274;576
6;770;51;301;304;605
6;778;50;301;271;572
6;105;17;301;254;555
6;875;10;301;300;601
6;210;40;300;300;600
6;588;34;300;303;603
6;63;33;300;313;613
6;588;23;300;274;574
6;875;13;300;293;593
6;854;9;300;286;586
6;469;4;300;308;608
6;392;3;300;249;549
6;112;3;300;286;586
6;420;68;299;314;613
6;224;60;299;438;737
6;778;44;299;312;611
6;588;40;299;289;588
6;63;35;299;286;585
6;826;25;299;297;596
6;875;18;299;273;572
6;854;16;299;311;610
6;868;12;299;260;559
6;868;4;299;267;566
6;665;2;299;297;596
6;413;69;298;421;719
6;623;68;298;413;711
6;833;60;298;312;610
6;210;41;298;307;605
6;210;24;298;312;610
6;266;19;298;245;543
6;483;11;298;297;595
6;854;10;298;295;593
6;203;9;298;269;567
6;658;84;297;930;1227
6;760;76;297;550;847
6;770;59;297;261;558
6;770;58;297;294;591
6;770;49;297;294;591
6;875;16;297;293;590
6;665;0;297;265;562
6;274;79;296;388;684
6;274;78;296;406;702
6;638;77;296;366;662
6;410;76;296;432;728
6;826;37;296;315;611
6;217;35;296;293;589
6;833;33;296;365;661
6;665;30;296;259;555
6;469;20;296;285;581
6;203;20;296;241;537
6;105;15;296;278;574
6;581;72;295;411;706
6;49;70;295;213;508
6;532;61;295;348;643
6;833;52;295;273;568
6;224;52;295;416;711
6;532;50;295;439;734
6;210;44;295;241;536
6;665;15;295;307;602
6;392;12;295;268;563
6;483;9;295;312;607
6;882;67;294;458;752
6;770;55;294;269;563
6;532;53;294;437;731
6;210;39;294;297;591
6;63;36;294;307;601
6;826;34;294;287;581
6;868;19;294;214;508
6;854;14;294;290;584
6;875;8;294;263;557
6;868;3;294;276;570
6;714;0;294;283;577
6;410;80;293;301;594
6;260;77;293;413;706
6;623;67;293;519;812
6;525;47;293;294;587
6;280;40;293;269;562
6;588;38;293;313;606
6;469;31;293;316;609
6;63;28;293;283;576
6;875;12;293;309;602
6;392;10;293;249;542
6;280;3;293;278;571
6;49;69;292;279;571
6;126;66;292;271;563
6;833;63;292;348;640
6;648;55;292;254;546
6;525;44;292;300;592
6;826;36;292;337;629
6;217;27;292;327;619
6;469;26;292;233;525
6;217;24;292;278;570
6;392;16;292;244;536
6;854;8;292;271;563
6;392;8;292;244;536
6;70;8;292;274;566
6;875;1;292;263;555
6;49;53;291;378;669
6;134;41;291;309;600
6;112;20;291;280;571
6;714;14;291;262;553
6;280;13;291;304;595
6;280;4;291;314;605
6;434;86;290;846;1136
6;525;46;290;271;561
6;826;40;290;279;569
6;707;14;290;260;550
6;483;14;290;276;566
6;868;7;290;234;524
6;119;6;290;248;538
6;483;5;290;317;607
6;49;63;289;383;672
6;525;48;289;275;564
6;525;45;289;298;587
6;217;38;289;267;556
6;70;30;289;273;562
6;854;18;289;283;572
6;483;15;289;296;585
6;266;15;289;259;548
6;707;11;289;232;521
6;770;57;288;252;540
6;826;41;288;243;531
6;609;38;288;270;558
6;469;35;288;283;571
6;469;29;288;306;594
6;392;15;288;249;537
6;70;12;288;286;574
6;70;10;288;254;542
6;665;7;288;285;573
6;833;55;287;309;596
6;413;55;287;499;786
6;770;53;287;324;611
6;826;21;287;292;579
6;483;16;287;268;555
6;763;78;286;499;785
6;260;78;286;354;640
6;98;66;286;403;689
6;364;59;286;461;747
6;588;29;286;308;594
6;217;26;286;267;553
6;63;25;286;295;581
6;483;17;286;271;557
6;602;16;286;266;552
6;714;15;286;250;536
6;875;11;286;308;594
6;203;11;286;278;564
6;875;6;286;282;568
6;392;6;286;251;537
6;515;79;285;591;876
6;791;77;285;385;670
6;595;76;285;387;672
6;833;56;285;328;613
6;854;12;285;258;543
6;105;7;285;253;538
6;266;0;285;271;556
6;70;0;285;230;515
6;638;73;284;526;810
6;882;70;284;365;649
6;224;66;284;346;630
6;532;64;284;270;554
6;210;62;284;242;526
6;588;47;284;298;582
6;63;47;284;282;566
6;588;46;284;291;575
6;245;43;284;348;632
6;245;42;284;280;564
6;210;26;284;295;579
6;505;23;284;131;415
6;105;14;284;273;557
6;483;12;284;282;566
6;483;4;284;295;579
6;882;72;283;275;558
6;778;55;283;249;532
6;648;48;283;384;667
6;770;42;283;351;634
6;63;40;283;249;532
6;469;33;283;302;585
6;665;29;283;265;548
6;826;27;283;293;576
6;70;20;283;258;541
6;483;19;283;278;561
6;602;17;283;284;567
6;854;13;283;245;528
6;714;7;283;280;563
6;483;3;283;299;582
6;252;72;282;272;554
6;609;30;282;279;561
6;63;27;282;311;593
6;182;64;281;419;700
6;210;61;281;267;548
6;63;34;281;318;599
6;182;28;281;523;804
6;112;28;281;266;547
6;280;21;281;269;550
6;105;19;281;244;525
6;665;18;281;305;586
6;707;5;281;252;533
6;392;2;281;248;529
6;483;1;281;293;574
6;833;74;280;229;509
6;648;56;280;278;558
6;525;42;280;297;577
6;469;28;280;291;571
6;280;25;280;279;559
6;665;4;280;313;593
6;581;71;279;322;601
6;595;69;279;447;726
6;280;35;279;292;571
6;217;34;279;279;558
6;609;31;279;267;546
6;63;30;279;339;618
6;217;22;279;271;550
6;665;13;279;256;535
6;266;12;279;247;526
6;875;9;279;311;590
6;665;8;279;307;586
6;854;6;279;299;578
6;714;6;279;291;570
6;875;2;279;242;521
6;770;54;278;338;616
6;469;34;278;278;556
6;112;32;278;292;570
6;469;24;278;252;530
6;483;8;278;290;568
6;70;6;278;303;581
6;441;88;277;619;896
6;274;81;277;385;662
6;760;80;277;544;821
6;778;52;277;232;509
6;134;45;277;258;535
6;112;29;277;277;554
6;868;20;277;204;481
6;483;20;277;295;572
6;609;18;277;271;548
6;868;15;277;256;533
6;70;15;277;254;531
6;714;8;277;278;555
6;266;3;277;261;538
6;266;1;277;262;539
6;49;62;276;315;591
6;134;46;276;283;559
6;63;26;276;297;573
6;469;21;276;249;525
6;609;19;276;286;562
6;238;10;276;211;487
6;665;9;276;261;537
6;868;6;276;270;546
6;70;5;276;295;571
6;868;1;276;260;536
6;609;0;276;316;592
6;134;50;275;271;546
6;778;48;275;283;558
6;588;48;275;312;587
6;826;44;275;245;520
6;469;38;275;271;546
6;203;27;275;249;524
6;854;17;275;281;556
6;70;11;275;291;566
6;266;9;275;289;564
6;875;4;275;280;555
6;638;76;274;485;759
6;98;68;274;340;614
6;210;47;274;300;574
6;210;46;274;269;543
6;203;40;274;270;544
6;665;35;274;218;492
6;70;18;274;250;524
6;105;12;274;247;521
6;665;11;274;263;537
6;714;10;274;293;567
6;560;76;273;760;1033
6;778;49;273;283;556
6;63;39;273;279;552
6;588;21;273;257;530
6;875;20;273;303;576
6;707;16;273;213;486
6;203;13;273;271;544
6;70;13;273;236;509
6;707;10;273;235;508
6;77;10;273;270;543
6;203;4;273;252;525
6;714;2;273;270;543
6;588;50;272;294;566
6;532;44;272;399;671
6;203;38;272;267;539
6;112;33;272;261;533
6;392;5;272;256;528
6;714;4;272;244;516
6;427;90;271;660;931
6;861;87;271;568;839
6;532;66;271;157;428
6;210;56;271;277;548
6;210;45;271;308;579
6;648;42;271;509;780
6;868;31;271;227;498
6;483;30;271;299;570
6;588;25;271;244;515
6;280;22;271;265;536
6;665;16;271;283;554
6;392;9;271;258;529
6;392;7;271;262;533
6;854;5;271;282;553
6;707;4;271;241;512
6;868;0;271;269;540
6;588;49;270;292;562
6;63;45;270;279;549
6;217;39;270;251;521
6;665;25;270;223;493
6;826;22;270;262;532
6;868;16;270;255;525
6;665;12;270;258;528
6;266;8;270;262;532
6;119;7;270;236;506
6;875;3;270;271;541
6;707;3;270;243;513
6;778;46;269;268;537
6;112;39;269;249;518
6;505;25;269;138;407
6;875;19;269;273;542
6;714;19;269;253;522
6;854;15;269;295;564
6;854;4;269;263;532
6;854;3;269;252;521
6;854;0;269;288;557
6;763;77;268;358;626
6;623;77;268;516;784
6;532;68;268;219;487
6;588;58;268;236;504
6;210;55;268;258;526
6;210;53;268;263;531
6;182;53;268;326;594
6;245;44;268;309;577
6;203;37;268;255;523
6;63;37;268;281;549
6;609;36;268;290;558
6;665;28;268;253;521
6;665;24;268;265;533
6;588;24;268;290;558
6;280;24;268;286;554
6;602;15;268;253;521
6;602;13;268;248;516
6;868;9;268;260;528
6;203;8;268;280;548
6;119;4;268;262;530
6;875;0;268;239;507
6;35;86;267;625;892
6;595;79;267;349;616
6;648;62;267;211;478
6;49;61;267;416;683
6;182;56;267;229;496
6;134;48;267;277;544
6;280;34;267;266;533
6;203;30;267;269;536
6;77;11;267;227;494
6;392;1;267;268;535
6;91;83;266;379;645
6;749;76;266;515;781
6;413;68;266;375;641
6;413;62;266;382;648
6;182;60;266;268;534
6;525;50;266;243;509
6;483;29;266;263;529
6;203;24;266;274;540
6;483;23;266;263;529
6;70;17;266;257;523
6;70;16;266;271;537
6;392;14;266;286;552
6;714;12;266;258;524
6;714;5;266;265;531
6;868;2;266;256;522
6;714;1;266;253;519
6;210;52;265;259;524
6;49;52;265;318;583
6;778;43;265;309;574
6;134;43;265;288;553
6;854;31;265;238;503
6;203;31;265;237;502
6;854;29;265;263;528
6;70;29;265;252;517
6;602;18;265;273;538
6;105;16;265;277;542
6;203;12;265;272;537
6;260;74;264;639;903
6;270;67;264;326;590
6;833;65;264;360;624
6;224;64;264;344;608
6;588;44;264;290;554
6;217;40;264;261;525
6;203;33;264;251;515
6;70;33;264;239;503
6;280;23;264;286;550
6;483;18;264;262;526
6;77;14;264;255;519
6;714;11;264;290;554
6;105;8;264;223;487
6;203;5;264;280;544
6;707;1;264;241;505
6;623;69;263;311;574
6;420;69;263;262;525
6;770;60;263;259;522
6;210;59;263;306;569
6;778;56;263;254;517
6;224;54;263;453;716
6;469;43;263;265;528
6;609;29;263;237;500
6;875;28;263;229;492
6;483;28;263;231;494
6;588;27;263;303;566
6;112;23;263;237;500
6;854;20;263;247;510
6;266;10;263;272;535
6;105;10;263;217;480
6;568;86;262;537;799
6;623;76;262;281;543
6;413;73;262;295;557
6;245;54;262;319;581
6;112;44;262;258;520
6;280;38;262;273;535
6;112;21;262;243;505
6;266;16;262;267;529
6;602;12;262;264;526
6;854;2;262;272;534
6;854;1;262;279;541
6;70;1;262;261;523
6;280;39;261;273;534
6;280;33;261;281;542
6;505;31;261;137;398
6;266;13;261;267;528
6;266;6;261;257;518
6;392;4;261;232;493
6;224;70;260;278;538
6;112;45;260;254;514
6;203;41;260;263;523
6;63;41;260;289;549
6;280;37;260;249;509
6;280;31;260;278;538
6;203;29;260;292;552
6;70;28;260;240;500
6;826;24;260;289;549
6;602;11;260;246;506
6;266;11;260;265;525
6;707;9;260;227;487
6;868;8;260;267;527
6;105;6;260;258;518
6;644;5;260;231;491
6;714;3;260;266;526
6;602;1;260;232;492
6;203;1;260;259;519
6;648;61;259;260;519
6;469;42;259;246;505
6;469;41;259;255;514
6;609;40;259;234;493
6;483;33;259;276;535
6;875;30;259;232;491
6;280;28;259;245;504
6;483;24;259;264;523
6;588;22;259;261;520
6;392;18;259;238;497
6;707;17;259;239;498
6;602;10;259;261;520
6;707;8;259;222;481
6;875;5;259;303;562
6;119;2;259;234;493
6;560;80;258;866;1124
6;532;60;258;351;609
6;245;60;258;253;511
6;210;57;258;267;525
6;134;56;258;227;485
6;778;51;258;275;533
6;588;51;258;266;524
6;609;39;258;269;527
6;868;29;258;211;469
6;833;22;258;299;557
6;266;22;258;251;509
6;203;21;258;251;509
6;392;17;258;269;527
6;714;9;258;273;531
6;210;54;257;269;526
6;217;37;257;291;548
6;112;34;257;264;521
6;280;32;257;278;535
6;505;29;257;139;396
6;203;28;257;272;529
6;588;26;257;283;540
6;70;24;257;222;479
6;469;22;257;246;503
6;602;9;257;231;488
6;119;8;257;238;495
6;203;7;257;252;509
6;119;1;257;239;496
6;224;72;256;318;574
6;648;65;256;293;549
6;182;59;256;269;525
6;63;56;256;253;509
6;778;54;256;271;527
6;525;52;256;227;483
6;134;52;256;231;487
6;217;50;256;236;492
6;833;44;256;397;653
6;203;42;256;241;497
6;826;23;256;251;507
6;119;19;256;201;457
6;266;17;256;237;493
6;77;17;256;233;489
6;490;87;255;639;894
6;539;84;255;508;763
6;410;79;255;460;715
6;182;65;255;252;507
6;833;62;255;449;704
6;648;59;255;291;546
6;469;49;255;245;500
6;182;49;255;240;495
6;483;35;255;247;502
6;266;31;255;234;489
6;707;18;255;267;522
6;791;75;254;437;691
6;413;72;254;240;494
6;497;69;254;415;669
6;224;68;254;358;612
6;134;53;254;231;485
6;63;48;254;249;503
6;112;46;254;233;487
6;63;46;254;284;538
6;826;43;254;258;512
6;588;41;254;270;524
6;665;21;254;265;519
6;602;5;254;206;460
6;70;4;254;255;509
6;707;2;254;232;486
6;56;84;253;681;934
6;882;74;253;245;498
6;413;70;253;428;681
6;270;68;253;397;650
6;826;42;253;247;500
6;707;30;253;242;495
6;505;28;253;138;391
6;203;26;253;248;501
6;112;22;253;234;487
6;392;19;253;220;473
6;665;10;253;284;537
6;266;5;253;267;520
6;602;4;253;242;495
6;203;3;253;256;509
6;182;52;252;272;524
6;63;50;252;265;517
6;525;49;252;260;512
6;63;49;252;263;515
6;588;43;252;283;535
6;469;40;252;280;532
6;469;39;252;252;504
6;203;36;252;277;529
6;483;34;252;238;490
6;483;32;252;255;507
6;483;31;252;284;536
6;609;28;252;274;526
6;714;27;252;206;458
6;469;27;252;274;526
6;505;26;252;110;362
6;505;24;252;136;388
6;266;18;252;266;518
6;707;6;252;259;511
6;119;5;252;282;534
6;644;2;252;217;469
6;805;81;251;426;677
6;763;81;251;337;588
6;98;65;251;425;676
6;833;58;251;313;564
6;182;58;251;290;541
6;210;51;251;237;488
6;210;48;251;268;519
6;112;47;251;271;522
6;826;45;251;241;492
6;203;45;251;251;502
6;609;32;251;275;526
6;266;32;251;235;486
6;469;25;251;275;526
6;266;24;251;244;495
6;469;23;251;242;493
6;714;20;251;235;486
6;105;13;251;236;487
6;119;10;251;218;469
6;665;5;251;277;528
6;112;55;250;248;498
6;778;53;250;263;513
6;868;39;250;212;462
6;203;32;250;262;512
6;392;30;250;225;475
6;875;25;250;213;463
6;609;24;250;230;480
6;70;22;250;254;504
6;266;20;250;247;497
6;602;19;250;241;491
6;868;14;250;293;543
6;868;13;250;268;518
6;392;13;250;286;536
6;70;3;250;260;510
6;245;64;249;131;380
6;210;49;249;292;541
6;203;39;249;264;513
6;665;34;249;232;481
6;505;30;249;138;387
6;112;24;249;213;462
6;868;18;249;245;494
6;749;77;248;352;600
6;623;73;248;453;701
6;420;71;248;267;515
6;270;69;248;392;640
6;532;62;248;328;576
6;210;60;248;268;516
6;63;53;248;246;494
6;826;49;248;275;523
6;588;42;248;294;542
6;112;40;248;261;509
6;469;36;248;260;508
6;203;25;248;239;487
6;203;23;248;247;495
6;868;22;248;233;481
6;707;15;248;265;513
6;119;9;248;236;484
6;602;3;248;250;498
6;638;78;247;403;650
6;763;76;247;330;577
6;420;72;247;254;501
6;588;61;247;221;468
6;532;56;247;367;614
6;588;55;247;248;495
6;134;54;247;257;504
6;826;48;247;236;483
6;203;46;247;252;499
6;70;31;247;257;504
6;868;30;247;256;503
6;483;26;247;249;496
6;119;0;247;242;489
6;412;78;246;355;601
6;245;61;246;251;497
6;63;60;246;227;473
6;469;57;246;212;458
6;525;51;246;249;495
6;210;43;246;264;510
6;833;41;246;442;688
6;217;36;246;308;554
6;105;28;246;224;470
6;483;27;246;235;481
6;105;21;246;211;457
6;420;70;245;343;588
6;49;66;245;317;562
6;588;56;245;251;496
6;63;51;245;238;483
6;203;44;245;239;484
6;105;27;245;201;446
6;266;25;245;202;447
6;483;21;245;256;501
6;77;20;245;243;488
6;392;0;245;254;499
6;112;60;244;227;471
6;588;52;244;272;516
6;280;49;244;227;471
6;63;44;244;273;517
6;875;22;244;226;470
6;707;22;244;223;467
6;665;22;244;222;466
6;609;22;244;231;475
6;105;20;244;214;458
6;77;19;244;221;465
6;119;11;244;207;451
6;644;6;244;247;491
6;77;5;244;236;480
6;581;78;243;277;520
6;483;37;243;196;439
6;868;32;243;276;519
6;280;29;243;313;556
6;609;25;243;261;504
6;707;21;243;179;422
6;238;13;243;221;464
6;833;67;242;305;547
6;588;65;242;265;507
6;532;63;242;226;468
6;778;57;242;263;505
6;63;57;242;219;461
6;63;52;242;245;487
6;609;49;242;232;474
6;469;45;242;238;480
6;469;37;242;284;526
6;105;36;242;239;481
6;203;35;242;280;522
6;609;33;242;250;492
6;280;27;242;258;500
6;875;24;242;241;483
6;105;24;242;219;461
6;665;23;242;248;490
6;505;22;242;136;378
6;505;21;242;141;383
6;714;16;242;233;475
6;77;15;242;258;500
6;266;2;242;277;519
6;778;58;241;242;483
6;525;55;241;208;449
6;112;53;241;260;501
6;714;17;241;250;491
6;105;11;241;226;467
6;77;8;241;224;465
6;252;74;240;301;541
6;217;53;240;230;470
6;826;52;240;215;455
6;210;50;240;263;503
6;112;48;240;272;512
6;469;47;240;266;506
6;665;20;240;266;506
6;238;16;240;207;447
6;714;13;240;243;483
6;602;8;240;240;480
6;175;4;240;194;434
6;840;87;239;577;816
6;760;81;239;351;590
6;410;78;239;491;730
6;595;73;239;390;629
6;770;62;239;254;493
6;203;50;239;267;506
6;112;49;239;228;467
6;217;45;239;221;460
6;63;43;239;257;496
6;609;35;239;275;514
6;714;25;239;247;486
6;70;25;239;219;458
6;70;21;239;217;456
6;868;17;239;247;486
6;77;16;239;261;500
6;77;13;239;223;462
6;707;12;239;240;479
6;119;12;239;225;464
6;707;7;239;260;499
6;371;88;238;574;812
6;882;71;238;290;528
6;210;63;238;247;485
6;182;61;238;317;555
6;826;47;238;278;516
6;609;44;238;222;460
6;875;35;238;205;443
6;714;30;238;224;462
6;714;22;238;232;470
6;609;21;238;252;490
6;238;15;238;228;466
6;77;9;238;253;491
6;224;71;237;240;477
6;182;67;237;229;466
6;770;63;237;208;445
6;217;55;237;216;453
6;112;51;237;271;508
6;217;46;237;235;472
6;217;41;237;245;482
6;875;31;237;230;467
6;105;30;237;196;433
6;280;26;237;216;453
6;623;74;236;328;564
6;224;74;236;205;441
6;63;63;236;220;456
6;588;54;236;241;477
6;588;53;236;268;504
6;609;46;236;251;487
6;469;46;236;239;475
6;665;37;236;204;440
6;266;34;236;228;464
6;854;30;236;261;497
6;602;30;236;228;464
6;238;12;236;219;455
6;77;6;236;249;485
6;77;3;236;203;439
6;105;2;236;234;470
6;412;79;235;301;536
6;469;60;235;265;500
6;588;59;235;234;469
6;112;38;235;286;521
6;854;34;235;234;469
6;665;33;235;231;466
6;105;31;235;212;447
6;868;28;235;217;452
6;112;27;235;279;514
6;105;23;235;185;420
6;105;18;235;259;494
6;602;0;235;204;439
6;623;78;234;243;477
6;532;67;234;256;490
6;469;58;234;232;466
6;134;49;234;248;482
6;469;48;234;251;485
6;826;46;234;249;483
6;609;45;234;233;467
6;280;44;234;232;466
6;609;42;234;243;477
6;609;37;234;267;501
6;280;36;234;270;504
6;105;33;234;226;460
6;105;29;234;205;439
6;665;27;234;251;485
6;112;25;234;238;472
6;875;21;234;218;452
6;266;4;234;268;502
6;763;80;233;366;599
6;588;60;233;254;487
6;182;57;233;205;438
6;112;57;233;209;442
6;134;55;233;241;474
6;469;53;233;229;462
6;70;34;233;220;453
6;714;29;233;210;443
6;714;26;233;217;450
6;105;9;233;265;498
6;602;7;233;246;479
6;644;3;233;220;453
6;644;1;233;231;464
6;105;0;233;229;462
6;56;86;232;548;780
6;595;75;232;307;539
6;532;57;232;355;587
6;525;56;232;204;436
6;826;50;232;258;490
6;609;50;232;217;449
6;280;41;232;236;468
6;483;38;232;222;454
6;868;34;232;219;451
6;119;16;232;221;453
6;707;13;232;243;475
6;602;2;232;210;442
6;644;0;232;236;468
6;791;78;231;416;647
6;252;76;231;240;471
6;182;63;231;439;670
6;469;50;231;265;496
6;483;40;231;230;461
6;854;35;231;241;472
6;714;32;231;233;464
6;707;31;231;239;470
6;483;22;231;258;489
6;203;22;231;224;455
6;196;15;231;204;435
6;175;14;231;210;441
6;644;4;231;232;463
6;77;2;231;215;446
6;434;88;230;560;790
6;408;81;230;356;586
6;364;67;230;210;440
6;532;59;230;267;497
6;134;51;230;241;471
6;203;49;230;232;462
6;217;48;230;231;461
6;609;47;230;232;462
6;280;47;230;250;480
6;854;37;230;225;455
6;392;29;230;227;457
6;665;26;230;283;513
6;609;23;230;258;488
6;266;21;230;233;463
6;238;18;230;217;447
6;515;81;229;500;729
6;497;72;229;341;570
6;210;65;229;245;474
6;112;54;229;257;486
6;609;41;229;232;461
6;854;40;229;222;451
6;868;37;229;217;446
6;112;36;229;271;500
6;868;35;229;221;450
6;609;34;229;299;528
6;665;31;229;263;492
6;707;28;229;216;445
6;868;24;229;215;444
6;714;18;229;294;523
6;238;11;229;262;491
6;644;9;229;218;447
6;77;4;229;226;455
6;119;3;229;252;481
6;77;1;229;237;466
6;70;39;228;227;455
6;714;35;228;223;451
6;854;33;228;230;458
6;875;29;228;231;459
6;868;25;228;194;422
6;483;25;228;239;467
6;714;24;228;204;432
6;119;15;228;198;426
6;644;10;228;229;457
6;238;8;228;214;442
6;203;2;228;251;479
6;70;2;228;253;481
6;707;0;228;253;481
6;371;87;227;710;937
6;749;78;227;462;689
6;532;72;227;123;350
6;270;71;227;145;372
6;224;69;227;293;520
6;63;58;227;232;459
6;245;57;227;367;594
6;134;57;227;242;469
6;826;53;227;207;434
6;266;35;227;232;459
6;714;31;227;234;461
6;609;26;227;264;491
6;714;23;227;209;436
6;392;20;227;210;437
6;707;19;227;234;461
6;119;14;227;232;459
6;644;12;227;194;421
6;63;54;226;245;471
6;280;50;226;214;440
6;203;48;226;233;459
6;280;42;226;221;447
6;70;32;226;237;463
6;602;20;226;214;440
6;119;17;226;214;440
6;252;80;225;193;418
6;623;75;225;441;666
6;210;64;225;228;453
6;588;62;225;242;467
6;525;53;225;226;451
6;245;48;225;397;622
6;217;47;225;239;464
6;483;36;225;234;459
6;392;28;225;212;437
6;875;23;225;259;484
6;238;17;225;243;468
6;105;3;225;266;491
6;497;73;224;342;566
6;833;70;224;258;482
6;392;47;224;160;384
6;112;37;224;269;493
6;644;31;224;211;435
6;77;28;224;224;448
6;875;27;224;231;455
6;266;27;224;233;457
6;505;20;224;157;381
6;119;18;224;243;467
6;175;15;224;204;428
6;238;7;224;205;429
6;77;7;224;237;461
6;77;0;224;240;464
6;410;83;223;441;664
6;91;81;223;382;605
6;595;77;223;356;579
6;833;61;223;245;468
6;609;60;223;201;424
6;210;58;223;260;483
6;588;57;223;269;492
6;182;55;223;374;597
6;469;54;223;258;481
6;203;34;223;255;478
6;392;27;223;213;436
6;854;22;223;200;423
6;238;3;223;178;401
6;260;80;222;386;608
6;588;64;222;243;465
6;770;61;222;239;461
6;63;55;222;257;479
6;280;46;222;235;457
6;714;37;222;239;461
6;868;26;222;240;462
6;714;21;222;234;456
6;77;18;222;238;460
6;91;82;221;370;591
6;420;74;221;257;478
6;420;73;221;220;441
6;364;64;221;232;453
6;217;60;221;215;436
6;63;59;221;242;463
6;525;57;221;194;415
6;609;55;221;225;446
6;854;46;221;201;422
6;665;32;221;257;478
6;602;25;221;165;386
6;105;4;221;212;433
6;35;87;220;533;753
6;35;85;220;734;954
6;791;80;220;396;616
6;638;75;220;488;708
6;778;60;220;210;430
6;203;53;220;216;436
6;105;45;220;206;426
6;875;39;220;176;396
6;392;35;220;214;434
6;707;32;220;219;439
6;854;24;220;245;465
6;266;23;220;227;447
6;728;18;220;200;420
6;728;11;220;178;398
6;644;7;220;210;430
6;602;6;220;239;459
6;105;5;220;214;434
6;539;85;219;360;579
6;515;80;219;474;693
6;274;80;219;399;618
6;826;58;219;200;419
6;134;58;219;237;456
6;203;54;219;210;429
6;609;52;219;212;431
6;217;51;219;240;459
6;203;43;219;206;425
6;217;42;219;255;474
6;63;42;219;248;467
6;868;40;219;212;431
6;483;39;219;241;460
6;875;32;219;236;455
6;392;32;219;220;439
6;392;31;219;226;445
6;868;27;219;229;448
6;175;12;219;218;437
6;238;9;219;201;420
6;280;60;218;242;460
6;217;56;218;208;426
6;602;37;218;247;465
6;854;32;218;242;460
6;644;30;218;276;494
6;77;29;218;209;427
6;119;13;218;211;429
6;728;12;218;187;405
6;126;67;217;292;509
6;833;64;217;301;518
6;203;61;217;224;441
6;112;59;217;221;438
6;826;54;217;233;450
6;217;52;217;224;441
6;105;35;217;211;428
6;868;33;217;269;486
6;602;33;217;208;425
6;644;28;217;199;416
6;77;24;217;221;438
6;70;23;217;194;411
6;728;21;217;180;397
6;119;21;217;192;409
6;119;20;217;228;445
6;728;17;217;176;393
6;77;12;217;256;473
6;412;81;216;333;549
6;182;66;216;175;391
6;182;62;216;320;536
6;134;61;216;202;418
6;469;56;216;225;441
6;469;55;216;221;437
6;217;54;216;212;428
6;469;52;216;223;439
6;203;51;216;219;435
6;203;47;216;244;460
6;392;45;216;175;391
6;217;43;216;203;419
6;112;42;216;221;437
6;70;42;216;185;401
6;105;32;216;218;434
6;392;26;216;231;447
6;266;26;216;204;420
6;70;26;216;228;444
6;735;16;216;173;389
6;238;6;216;233;449
6;408;75;215;653;868
6;49;74;215;229;444
6;770;65;215;245;460
6;469;61;215;207;422
6;70;37;215;229;444
6;665;36;215;216;431
6;266;36;215;201;416
6;602;35;215;228;443
6;119;30;215;192;407
6;707;23;215;218;433
6;707;20;215;254;469
6;196;16;215;204;419
6;49;68;214;254;468
6;210;66;214;241;455
6;364;65;214;210;424
6;112;64;214;191;405
6;203;55;214;209;423
6;203;52;214;246;460
6;112;52;214;261;475
6;854;47;214;202;416
6;469;44;214;262;476
6;714;39;214;214;428
6;112;35;214;267;481
6;602;34;214;225;439
6;602;31;214;226;440
6;728;24;214;186;400
6;196;17;214;202;416
6;238;5;214;230;444
6;658;88;213;544;757
6;791;76;213;271;484
6;98;69;213;368;581
6;112;58;213;246;459
6;826;55;213;244;457
6;70;49;213;168;381
6;868;41;213;200;413
6;644;36;213;170;383
6;70;36;213;213;426
6;266;33;213;216;429
6;868;23;213;201;414
6;728;16;213;172;385
6;728;5;213;191;404
6;515;82;212;377;589
6;98;73;212;229;441
6;826;51;212;228;440
6;609;48;212;253;465
6;854;42;212;193;405
6;602;39;212;209;421
6;105;34;212;233;445
6;714;28;212;225;437
6;505;27;212;124;336
6;875;26;212;208;420
6;112;26;212;255;467
6;105;22;212;177;389
6;77;21;212;214;426
6;644;15;212;177;389
6;833;69;211;180;391
6;245;67;211;182;393
6;245;62;211;171;382
6;112;61;211;222;433
6;483;48;211;211;422
6;280;45;211;214;425
6;217;44;211;236;447
6;266;40;211;194;405
6;505;32;211;133;344
6;707;27;211;193;404
6;105;25;211;192;403
6;602;23;211;213;424
6;175;13;211;181;392
6;728;8;211;184;395
6;728;7;211;190;401
6;238;1;211;207;418
6;833;73;210;236;446
6;112;65;210;196;406
6;364;62;210;317;527
6;854;56;210;187;397
6;112;56;210;238;448
6;217;49;210;222;432
6;854;39;210;211;421
6;714;38;210;208;418
6;266;37;210;212;422
6;105;37;210;220;430
6;238;31;210;222;432
6;602;27;210;189;399
6;392;24;210;202;412
6;868;21;210;229;439
6;196;10;210;169;379
6;175;10;210;207;417
6;756;86;209;510;719
6;854;51;209;215;424
6;707;35;209;216;425
6;644;35;209;208;417
6;644;34;209;229;438
6;875;33;209;211;420
6;644;33;209;203;412
6;644;32;209;228;437
6;266;30;209;233;442
6;266;28;209;245;454
6;854;27;209;208;417
6;602;22;209;210;419
6;644;19;209;194;403
6;455;12;209;180;389
6;175;11;209;186;395
6;686;7;209;177;386
6;35;88;208;338;546
6;497;75;208;383;591
6;826;60;208;202;410
6;525;60;208;182;390
6;609;58;208;197;405
6;280;56;208;198;406
6;469;51;208;227;435
6;105;49;208;180;388
6;70;35;208;235;443
6;392;33;208;222;430
6;119;31;208;221;429
6;119;26;208;214;422
6;518;14;208;187;395
6;238;14;208;254;462
6;364;69;207;93;300
6;126;69;207;271;478
6;224;57;207;314;521
6;525;54;207;211;418
6;105;41;207;187;394
6;875;36;207;222;429
6;392;36;207;203;410
6;119;29;207;182;389
6;70;27;207;199;406
6;854;21;207;225;432
6;728;19;207;202;409
6;147;16;207;169;376
6;735;10;207;160;367
6;644;8;207;216;423
6;315;6;207;162;369
6;175;6;207;183;390
6;238;4;207;250;457
6;410;81;206;495;701
6;412;77;206;334;540
6;778;61;206;207;413
6;203;57;206;187;393
6;609;51;206;227;433
6;854;50;206;215;421
6;665;45;206;157;363
6;105;44;206;186;392
6;609;43;206;200;406
6;112;41;206;244;450
6;854;38;206;219;425
6;266;38;206;216;422
6;707;29;206;242;448
6;602;24;206;218;424
6;854;23;206;230;436
6;547;19;206;207;413
6;728;10;206;213;419
6;455;6;206;195;401
6;408;83;205;391;596
6;791;81;205;204;409
6;749;81;205;333;538
6;105;61;205;209;414
6;826;57;205;201;406
6;609;56;205;216;421
6;854;45;205;215;420
6;868;38;205;228;433
6;70;38;205;211;416
6;868;36;205;253;458
6;602;32;205;243;448
6;77;30;205;201;406
6;609;27;205;235;440
6;707;26;205;201;406
6;196;18;205;183;388
6;735;14;205;178;383
6;728;9;205;171;376
6;147;5;205;160;365
6;595;80;204;347;551
6;623;71;204;509;713
6;588;67;204;219;423
6;469;63;204;215;419
6;280;52;204;179;383
6;483;50;204;199;403
6;105;46;204;203;407
6;875;38;204;218;422
6;854;36;204;240;444
6;505;34;204;129;333
6;602;29;204;217;421
6;854;28;204;249;453
6;392;25;204;202;406
6;547;20;204;188;392
6;686;1;204;180;384
6;547;0;204;219;423
6;581;79;203;308;511
6;778;59;203;247;450
6;525;59;203;169;372
6;217;59;203;197;400
6;217;57;203;252;455
6;609;53;203;173;376
6;280;51;203;225;428
6;714;44;203;177;380
6;105;38;203;210;413
6;854;25;203;202;405
6;707;25;203;222;425
6;735;12;203;183;386
6;260;82;202;310;512
6;497;77;202;329;531
6;413;77;202;328;530
6;224;67;202;347;549
6;609;59;202;217;419
6;854;52;202;195;397
6;483;45;202;220;422
6;280;43;202;212;414
6;602;38;202;204;406
6;119;27;202;205;407
6;105;26;202;208;410
6;707;24;202;197;399
6;77;22;202;196;398
6;700;20;202;119;321
6;735;17;202;183;385
6;686;12;202;199;401
6;735;5;202;187;389
6;455;1;202;172;374
6;882;77;201;360;561
6;224;73;201;212;413
6;270;72;201;249;450
6;112;63;201;242;443
6;469;62;201;229;430
6;203;60;201;195;396
6;134;59;201;202;403
6;609;54;201;223;424
6;105;43;201;186;387
6;483;41;201;208;409
6;602;36;201;200;401
6;707;34;201;209;410
6;175;27;201;169;370
6;644;24;201;214;415
6;392;23;201;212;413
6;175;21;201;168;369
6;238;20;201;184;385
6;175;19;201;210;411
6;147;14;201;186;387
6;547;6;201;186;387
6;315;5;201;189;390
6;728;3;201;188;389
6;105;1;201;199;400
6;749;79;200;394;594
6;245;70;200;154;354
6;770;66;200;201;401
6;588;66;200;217;417
6;648;58;200;328;528
6;714;49;200;165;365
6;483;43;200;193;393
6;266;41;200;191;391
6;119;35;200;212;412
6;455;19;200;169;369
6;196;19;200;174;374
6;735;15;200;192;392
6;84;10;200;197;397
6;686;9;200;178;378
6;175;9;200;205;405
6;735;6;200;209;409
6;686;6;200;184;384
6;728;4;200;167;367
6;175;0;200;180;380
6;805;85;199;331;530
6;413;81;199;255;454
6;833;66;199;289;488
6;245;66;199;306;505
6;648;57;199;266;465
6;266;45;199;152;351
6;392;38;199;172;371
6;714;34;199;224;423
6;77;32;199;242;441
6;77;27;199;202;401
6;238;24;199;143;342
6;728;20;199;218;417
6;728;14;199;194;393
6;175;7;199;195;394
6;408;82;198;361;559
6;413;79;198;489;687
6;126;71;198;273;471
6;588;63;198;250;448
6;105;59;198;211;409
6;203;58;198;216;414
6;245;56;198;306;504
6;203;56;198;204;402
6;112;50;198;281;479
6;665;43;198;177;375
6;392;39;198;180;378
6;77;36;198;211;409
6;707;33;198;213;411
6;77;31;198;216;414
6;854;26;198;202;400
6;644;23;198;185;383
6;238;22;198;151;349
6;505;19;198;141;339
6;547;18;198;208;406
6;455;18;198;190;388
6;315;11;198;151;349
6;455;8;198;186;384
6;175;5;198;207;405
6;735;0;198;165;363
6;217;65;197;187;384
6;134;60;197;212;409
6;280;59;197;179;376
6;280;48;197;218;415
6;854;43;197;195;392
6;854;41;197;221;418
6;714;41;197;201;398
6;77;37;197;169;366
6;644;29;197;204;401
6;644;25;197;187;384
6;644;21;197;177;374
6;686;16;197;177;374
6;147;15;197;198;395
6;42;14;197;178;375
6;42;13;197;143;340
6;770;64;196;200;396
6;280;61;196;192;388
6;217;61;196;214;410
6;63;61;196;225;421
6;105;51;196;188;384
6;868;45;196;204;400
6;602;45;196;182;378
6;875;37;196;193;389
6;707;37;196;224;420
6;602;21;196;192;388
6;547;21;196;152;348
6;644;13;196;195;391
6;518;10;196;180;376
6;412;82;195;275;470
6;749;80;195;470;665
6;623;79;195;402;597
6;182;70;195;222;417
6;609;63;195;193;388
6;63;62;195;211;406
6;483;51;195;193;388
6;483;49;195;183;378
6;714;48;195;161;356
6;868;44;195;177;372
6;602;40;195;199;394
6;392;37;195;192;387
6;875;34;195;190;385
6;238;30;195;197;392
6;266;29;195;237;432
6;686;14;195;183;378
6;735;7;195;193;388
6;547;7;195;175;370
6;455;7;195;185;380
6;728;2;195;194;389
6;274;82;194;270;464
6;595;78;194;357;551
6;126;70;194;220;414
6;532;65;194;269;463
6;714;45;194;209;403
6;868;42;194;203;397
6;119;33;194;192;386
6;196;20;194;149;343
6;735;13;194;151;345
6;644;11;194;211;405
6;315;10;194;204;398
6;638;82;193;187;380
6;560;81;193;295;488
6;224;76;193;206;399
6;882;69;193;220;413
6;203;65;193;195;388
6;105;65;193;194;387
6;469;59;193;214;407
6;483;58;193;192;385
6;280;58;193;200;393
6;602;48;193;168;361
6;665;46;193;202;395
6;119;34;193;180;373
6;238;29;193;171;364
6;602;28;193;217;410
6;119;24;193;183;376
6;644;22;193;173;366
6;644;20;193;168;361
6;728;15;193;209;402
6;455;9;193;189;382
6;833;68;192;338;530
6;826;63;192;210;402
6;105;56;192;190;382
6;707;47;192;192;384
6;70;41;192;202;394
6;665;39;192;213;405
6;707;38;192;213;405
6;77;38;192;166;358
6;714;36;192;206;398
6;714;33;192;247;439
6;505;33;192;145;337
6;175;31;192;169;361
6;644;27;192;197;389
6;735;26;192;169;361
6;119;22;192;221;413
6;644;17;192;171;363
6;455;15;192;208;400
6;735;11;192;180;372
6;679;4;192;160;352
6;728;1;192;175;367
6;728;0;192;221;413
6;658;87;191;589;780
6;420;75;191;278;469
6;182;75;191;197;388
6;49;71;191;164;355
6;648;64;191;129;320
6;217;58;191;220;411
6;868;47;191;198;389
6;70;47;191;172;363
6;238;33;191;204;395
6;455;17;191;180;371
6;686;15;191;186;377
6;147;12;191;160;351
6;175;8;191;188;379
6;238;0;191;180;371
6;763;79;190;279;469
6;126;76;190;229;419
6;833;72;190;248;438
6;609;61;190;211;401
6;483;59;190;205;395
6;203;59;190;209;399
6;483;54;190;184;374
6;868;51;190;177;367
6;105;39;190;209;399
6;728;25;190;162;352
6;119;23;190;198;388
6;84;20;190;123;313
6;196;14;190;202;392
6;196;11;190;182;372
6;147;10;190;168;358
6;315;8;190;191;381
6;455;5;190;182;372
6;252;77;189;266;455
6;224;75;189;306;495
6;112;66;189;194;383
6;778;62;189;199;388
6;826;59;189;173;362
6;105;50;189;222;411
6;266;48;189;160;349
6;70;48;189;185;374
6;105;47;189;213;402
6;392;46;189;186;375
6;483;42;189;175;364
6;392;34;189;201;390
6;119;28;189;217;406
6;735;22;189;161;350
6;392;21;189;205;394
6;518;19;189;155;344
6;735;18;189;197;386
6;175;16;189;212;401
6;644;14;189;210;399
6;455;14;189;200;389
6;413;80;188;427;615
6;497;74;188;296;484
6;609;65;188;205;393
6;854;63;188;175;363
6;112;62;188;231;419
6;483;61;188;155;343
6;707;53;188;185;373
6;868;49;188;187;375
6;707;49;188;177;365
6;105;48;188;189;377
6;868;43;188;174;362
6;112;43;188;258;446
6;644;39;188;182;370
6;644;38;188;202;390
6;833;36;188;435;623
6;707;36;188;203;391
6;505;35;188;116;304
6;728;30;188;180;368
6;679;13;188;159;347
6;518;9;188;169;357
6;147;6;188;166;354
6;182;71;187;142;329
6;588;70;187;217;404
6;525;61;187;175;362
6;714;60;187;167;354
6;854;49;187;222;409
6;665;47;187;191;378
6;77;45;187;192;379
6;602;42;187;187;374
6;266;42;187;198;385
6;714;40;187;197;384
6;665;40;187;187;374
6;77;40;187;180;367
6;665;38;187;234;421
6;644;37;187;207;394
6;700;31;187;131;318
6;700;24;187;133;320
6;392;22;187;193;380
6;175;20;187;192;379
6;42;15;187;174;361
6;196;12;187;194;381
6;518;11;187;169;356
6;728;6;187;232;419
6;147;3;187;196;383
6;455;2;187;173;360
6;238;2;187;188;375
6;735;1;187;193;380
6;147;0;187;187;374
6;28;87;186;535;721
6;28;86;186;515;701
6;413;74;186;372;558
6;469;64;186;210;396
6;105;60;186;185;371
6;525;58;186;197;383
6;238;40;186;163;349
6;119;38;186;164;350
6;735;32;186;166;352
6;700;29;186;133;319
6;602;26;186;224;410
6;315;12;186;193;379
6;175;2;186;188;374
6;791;82;185;350;535
6;588;69;185;205;390
6;588;68;185;218;403
6;469;66;185;197;382
6;469;65;185;209;394
6;280;65;185;172;357
6;826;64;185;184;369
6;714;57;185;164;349
6;826;56;185;194;379
6;714;55;185;176;361
6;280;54;185;193;378
6;714;50;185;169;354
6;707;48;185;165;350
6;392;44;185;187;372
6;119;37;185;228;413
6;700;23;185;130;315
6;196;13;185;170;355
6;147;9;185;213;398
6;196;6;185;178;363
6;518;1;185;150;335
6;568;87;184;573;757
6;98;72;184;216;400
6;826;61;184;206;390
6;70;54;184;175;359
6;392;51;184;174;358
6;714;47;184;184;368
6;483;46;184;215;399
6;875;42;184;171;355
6;105;40;184;177;361
6;547;23;184;157;341
6;238;19;184;205;389
6;455;16;184;177;361
6;315;16;184;172;356
6;84;8;184;181;365
6;28;90;183;206;389
6;91;84;183;317;500
6;595;81;183;320;503
6;638;80;183;249;432
6;63;67;183;199;382
6;134;64;183;159;342
6;854;61;183;199;382
6;483;60;183;170;353
6;392;41;183;176;359
6;644;40;183;174;357
6;686;27;183;174;357
6;77;23;183;210;393
6;287;22;183;58;241
6;238;21;183;199;382
6;315;20;183;143;326
6;686;18;183;183;366
6;518;12;183;155;338
6;547;10;183;188;371
6;735;9;183;184;367
6;686;5;183;184;367
6;455;3;183;177;360
6;760;84;182;274;456
6;648;67;182;173;355
6;778;63;182;179;361
6;217;62;182;219;401
6;280;55;182;253;435
6;868;48;182;153;335
6;714;46;182;189;371
6;875;45;182;168;350
6;644;41;182;178;360
6;70;40;182;219;401
6;238;35;182;144;326
6;735;30;182;166;348
6;547;30;182;178;360
6;728;23;182;174;356
6;547;22;182;161;343
6;175;17;182;205;387
6;547;5;182;171;353
6;98;76;181;287;468
6;854;64;181;177;358
6;203;62;181;201;382
6;105;62;181;214;395
6;854;57;181;185;366
6;105;55;181;164;345
6;707;50;181;176;357
6;854;48;181;200;381
6;665;41;181;190;371
6;392;40;181;188;369
6;119;40;181;162;343
6;266;39;181;217;398
6;77;25;181;204;385
6;644;16;181;199;380
6;385;16;181;146;327
6;147;13;181;174;355
6;182;73;180;188;368
6;126;68;180;348;528
6;217;63;180;182;362
6;609;62;180;224;404
6;525;62;180;182;362
6;707;60;180;167;347
6;245;58;180;290;470
6;280;57;180;180;360
6;644;47;180;156;336
6;70;44;180;170;350
6;77;34;180;185;365
6;700;25;180;133;313
6;700;21;180;117;297
6;84;18;180;137;317
6;84;15;180;152;332
6;547;9;180;159;339
6;84;7;180;197;377
6;455;0;180;173;353
6;56;85;179;643;822
6;560;82;179;273;452
6;105;63;179;204;383
6;105;54;179;172;351
6;70;53;179;177;356
6;238;47;179;164;343
6;854;44;179;206;385
6;714;43;179;183;362
6;70;43;179;200;379
6;119;41;179;159;338
6;707;39;179;225;404
6;238;37;179;168;347
6;735;29;179;165;344
6;238;27;179;181;360
6;238;23;179;159;338
6;175;23;179;170;349
6;686;17;179;173;352
6;315;15;179;168;347
6;42;12;179;165;344
6;42;11;179;159;338
6;735;8;179;173;352
6;547;3;179;172;351
6;42;0;179;152;331
6;182;69;178;227;405
6;707;63;178;170;348
6;245;63;178;140;318
6;134;62;178;169;347
6;714;53;178;187;365
6;392;50;178;179;357
6;868;46;178;166;344
6;119;32;178;190;368
6;700;28;178;137;315
6;700;22;178;131;309
6;476;12;178;135;313
6;679;10;178;158;336
6;547;8;178;170;348
6;42;5;178;171;349
6;315;1;178;166;344
6;147;1;178;141;319
6;595;82;177;236;413
6;420;76;177;195;372
6;63;64;177;183;360
6;707;57;177;166;343
6;665;48;177;177;354
6;77;46;177;152;329
6;392;42;177;166;343
6;105;42;177;182;359
6;707;41;177;162;339
6;175;40;177;175;352
6;77;33;177;220;397
6;455;31;177;154;331
6;119;25;177;180;357
6;518;15;177;169;346
6;231;14;177;156;333
6;315;0;177;182;359
6;420;78;176;190;366
6;581;74;176;375;551
6;854;62;176;209;385
6;854;58;176;197;373
6;483;44;176;202;378
6;735;33;176;165;341
6;728;28;176;179;355
6;644;18;176;174;350
6;84;9;176;180;356
6;84;6;176;162;338
6;175;1;176;198;374
6;427;91;175;524;699
6;434;89;175;387;562
6;648;69;175;154;329
6;105;66;175;162;337
6;134;63;175;175;350
6;854;60;175;190;365
6;392;56;175;151;326
6;280;53;175;211;386
6;483;47;175;218;393
6;70;45;175;198;373
6;266;43;175;162;337
6;714;42;175;175;350
6;735;24;175;166;341
6;686;11;175;167;342
6;147;11;175;203;378
6;196;7;175;185;360
6;805;86;174;303;477
6;126;78;174;227;401
6;63;70;174;153;327
6;609;64;174;208;382
6;175;50;174;145;319
6;392;48;174;164;338
6;686;19;174;195;369
6;175;18;174;218;392
6;42;16;174;151;325
6;700;13;174;125;299
6;686;10;174;167;341
6;147;8;174;158;332
6;147;7;174;184;358
6;574;1;174;139;313
6;505;0;174;135;309
6;749;82;173;398;571
6;833;75;173;195;368
6;364;66;173;210;383
6;778;65;173;194;367
6;203;63;173;221;394
6;707;59;173;183;356
6;483;52;173;201;374
6;665;44;173;175;348
6;875;40;173;203;376
6;238;38;173;186;359
6;686;34;173;143;316
6;728;27;173;172;345
6;728;26;173;166;339
6;42;19;173;157;330
6;518;17;173;171;344
6;147;17;173;194;367
6;315;14;173;176;349
6;84;11;173;160;333
6;518;7;173;160;333
6;518;5;173;175;348
6;42;4;173;165;338
6;735;3;173;189;362
6;686;0;173;188;361
6;658;90;172;380;552
6;515;86;172;218;390
6;791;83;172;278;450
6;791;79;172;399;571
6;588;71;172;191;363
6;210;69;172;232;404
6;210;67;172;221;393
6;280;64;172;188;360
6;392;55;172;145;317
6;602;50;172;175;347
6;77;42;172;172;344
6;175;30;172;168;340
6;175;28;172;211;383
6;700;26;172;134;306
6;175;22;172;183;355
6;686;20;172;150;322
6;455;20;172;155;327
6;315;18;172;178;350
6;679;14;172;166;338
6;547;14;172;180;352
6;42;6;172;168;340
6;547;4;172;172;344
6;686;3;172;180;352
6;196;3;172;163;335
6;42;3;172;156;328
6;224;77;171;230;401
6;588;72;171;233;404
6;210;70;171;217;388
6;483;64;171;168;339
6;105;57;171;185;356
6;483;56;171;185;356
6;483;55;171;210;381
6;854;53;171;163;334
6;105;53;171;211;382
6;266;52;171;114;285
6;105;52;171;212;383
6;238;49;171;166;337
6;266;47;171;164;335
6;266;46;171;168;339
6;547;34;171;141;312
6;547;33;171;168;339
6;238;32;171;217;388
6;644;26;171;181;352
6;238;26;171;183;354
6;175;24;171;174;345
6;505;18;171;149;320
6;455;11;171;192;363
6;679;9;171;171;342
6;42;9;171;172;343
6;196;2;171;157;328
6;196;0;171;181;352
6;371;90;170;282;452
6;56;88;170;374;544
6;882;80;170;202;372
6;126;75;170;144;314
6;854;70;170;153;323
6;245;68;170;263;433
6;63;66;170;211;381
6;525;65;170;162;332
6;868;60;170;166;336
6;602;49;170;164;334
6;392;43;170;179;349
6;875;41;170;147;317
6;686;36;170;128;298
6;686;32;170;171;341
6;238;28;170;202;372
6;735;20;170;168;338
6;679;17;170;159;329
6;315;17;170;187;357
6;42;17;170;162;332
6;196;8;170;145;315
6;735;4;170;186;356
6;42;1;170;164;334
6;412;80;169;343;512
6;497;79;169;302;471
6;105;70;169;175;344
6;609;67;169;196;365
6;105;64;169;194;363
6;483;62;169;175;344
6;868;57;169;159;328
6;714;56;169;160;329
6;392;53;169;156;325
6;714;51;169;176;345
6;707;51;169;153;322
6;665;51;169;169;338
6;707;45;169;188;357
6;602;43;169;199;368
6;686;31;169;177;346
6;175;29;169;168;337
6;735;28;169;164;333
6;315;4;169;160;329
6;700;3;169;131;300
6;518;2;169;160;329
6;260;81;168;253;421
6;112;67;168;186;354
6;868;58;168;159;327
6;609;57;168;206;374
6;392;57;168;142;310
6;602;53;168;158;326
6;707;52;168;179;347
6;266;44;168;163;331
6;707;42;168;182;350
6;665;42;168;184;352
6;735;38;168;183;351
6;147;38;168;162;330
6;518;16;168;166;334
6;84;14;168;159;327
6;196;9;168;171;339
6;679;7;168;140;308
6;42;7;168;185;353
6;196;4;168;195;363
6;505;1;168;161;329
6;408;85;167;283;450
6;408;80;167;416;583
6;638;79;167;302;469
6;413;75;167;352;519
6;210;68;167;204;371
6;609;66;167;180;347
6;854;65;167;185;352
6;868;55;167;192;359
6;875;50;167;152;319
6;175;38;167;146;313
6;119;36;167;164;331
6;455;30;167;160;327
6;455;28;167;160;327
6;735;19;167;186;353
6;700;19;167;141;308
6;147;19;167;164;331
6;42;18;167;172;339
6;547;17;167;157;324
6;574;16;167;133;300
6;476;15;167;164;331
6;547;12;167;173;340
6;679;11;167;132;299
6;196;5;167;159;326
6;315;3;167;148;315
6;42;2;167;183;350
6;749;83;166;250;416
6;560;83;166;264;430
6;623;80;166;351;517
6;245;71;166;159;325
6;182;68;166;150;316
6;770;67;166;182;348
6;483;65;166;166;332
6;854;59;166;179;345
6;665;58;166;163;329
6;854;55;166;228;394
6;70;55;166;201;367
6;875;46;166;165;331
6;875;44;166;156;322
6;602;41;166;185;351
6;77;39;166;190;356
6;547;32;166;139;305
6;735;25;166;164;330
6;728;22;166;176;342
6;455;10;166;179;345
6;315;7;166;169;335
6;679;6;166;125;291
6;126;74;165;217;382
6;134;65;165;192;357
6;826;62;165;217;382
6;602;61;165;153;318
6;665;57;165;161;326
6;392;54;165;158;323
6;483;53;165;195;360
6;602;52;165;148;313
6;70;52;165;161;326
6;868;50;165;165;330
6;707;43;165;171;336
6;238;42;165;201;366
6;175;39;165;159;324
6;77;35;165;204;369
6;175;32;165;157;322
6;547;29;165;168;333
6;547;28;165;161;326
6;42;23;165;159;324
6;547;15;165;174;339
6;231;15;165;164;329
6;462;14;165;136;301
6;462;7;165;144;309
6;371;89;164;363;527
6;805;84;164;365;529
6;497;80;164;181;345
6;49;75;164;267;431
6;364;73;164;193;357
6;364;71;164;185;349
6;532;69;164;164;328
6;778;64;164;177;341
6;854;54;164;186;350
6;868;53;164;184;348
6;70;51;164;170;334
6;875;48;164;176;340
6;602;47;164;181;345
6;70;46;164;175;339
6;77;41;164;186;350
6;196;40;164;169;333
6;728;33;164;159;323
6;728;31;164;177;341
6;679;31;164;135;299
6;700;30;164;161;325
6;547;27;164;146;310
6;77;26;164;176;340
6;175;25;164;156;320
6;518;24;164;133;297
6;42;20;164;147;311
6;518;18;164;155;319
6;301;15;164;135;299
6;7;14;164;154;318
6;574;7;164;129;293
6;700;5;164;134;298
6;574;3;164;161;325
6;756;88;163;432;595
6;412;83;163;135;298
6;497;78;163;198;361
6;770;68;163;163;326
6;665;49;163;153;316
6;392;49;163;176;339
6;707;44;163;227;390
6;686;37;163;136;299
6;196;36;163;150;313
6;728;34;163;144;307
6;238;34;163;150;313
6;547;24;163;159;322
6;455;23;163;133;296
6;455;21;163;128;291
6;84;16;163;171;334
6;315;13;163;170;333
6;547;11;163;168;331
6;505;9;163;161;324
6;679;8;163;114;277
6;574;8;163;141;304
6;231;6;163;141;304
6;357;90;162;500;662
6;581;80;162;236;398
6;270;80;162;176;338
6;252;78;162;223;385
6;469;70;162;187;349
6;648;66;162;190;352
6;217;64;162;194;356
6;525;63;162;164;326
6;280;62;162;213;375
6;714;54;162;177;339
6;665;52;162;171;333
6;196;45;162;153;315
6;238;39;162;173;335
6;455;38;162;131;293
6;505;36;162;100;262
6;175;33;162;175;337
6;735;31;162;176;338
6;686;24;162;147;309
6;518;20;162;146;308
6;728;13;162;198;360
6;455;13;162;184;346
6;574;12;162;147;309
6;462;10;162;162;324
6;505;3;162;153;315
6;547;2;162;175;337
6;196;1;162;138;300
6;469;68;161;174;335
6;469;67;161;201;362
6;483;63;161;180;341
6;238;56;161;126;287
6;868;54;161;176;337
6;77;54;161;143;304
6;77;47;161;181;342
6;602;44;161;171;332
6;147;40;161;148;309
6;175;35;161;154;315
6;735;27;161;164;325
6;574;17;161;133;294
6;505;14;161;162;323
6;686;8;161;179;340
6;42;8;161;133;294
6;700;6;161;149;310
6;574;6;161;159;320
6;518;6;161;162;323
6;84;4;161;151;312
6;505;2;161;147;308
6;84;1;161;143;304
6;805;83;160;422;582
6;49;83;160;155;315
6;270;78;160;174;334
6;98;75;160;286;446
6;49;73;160;207;367
6;210;71;160;180;340
6;707;54;160;186;346
6;602;54;160;148;308
6;602;46;160;158;318
6;147;45;160;140;300
6;505;37;160;118;278
6;238;36;160;187;347
6;700;35;160;134;294
6;518;31;160;172;332
6;686;30;160;145;305
6;385;30;160;122;282
6;455;27;160;144;304
6;287;24;160;51;211
6;735;21;160;157;317
6;147;18;160;182;342
6;231;9;160;124;284
6;518;8;160;169;329
6;574;4;160;157;317
6;441;89;159;505;664
6;413;78;159;310;469
6;581;76;159;376;535
6;98;70;159;261;420
6;469;69;159;169;328
6;63;69;159;179;338
6;203;66;159;153;312
6;714;59;159;176;335
6;665;53;159;167;326
6;644;51;159;135;294
6;455;32;159;146;305
6;147;30;159;150;309
6;84;19;159;136;295
6;462;16;159;156;315
6;679;15;159;153;312
6;574;14;159;184;343
6;385;14;159;128;287
6;84;12;159;169;328
6;476;8;159;136;295
6;84;5;159;158;317
6;735;2;159;190;349
6;861;88;158;575;733
6;760;82;158;410;568
6;420;77;158;195;353
6;270;77;158;184;342
6;270;73;158;307;465
6;483;66;158;177;335
6;266;50;158;160;318
6;70;50;158;185;343
6;875;47;158;149;307
6;707;46;158;181;339
6;644;46;158;174;332
6;455;34;158;146;304
6;547;31;158;191;349
6;455;29;158;163;321
6;518;28;158;156;314
6;686;25;158;138;296
6;385;18;158;150;308
6;301;18;158;129;287
6;686;13;158;141;299
6;231;13;158;147;305
6;574;10;158;148;306
6;147;4;158;159;317
6;882;78;157;314;471
6;134;67;157;118;275
6;217;66;157;183;340
6;392;60;157;140;297
6;105;58;157;194;351
6;735;40;157;152;309
6;707;40;157;198;355
6;505;38;157;102;259
6;735;35;157;142;299
6;700;32;157;118;275
6;686;29;157;183;340
6;315;22;157;133;290
6;686;21;157;150;307
6;700;18;157;135;292
6;42;10;157;150;307
6;476;7;157;137;294
6;231;4;157;149;306
6;231;2;157;144;301
6;539;87;156;357;513
6;588;74;156;188;344
6;532;70;156;236;392
6;826;65;156;204;360
6;266;60;156;122;278
6;665;59;156;168;324
6;602;58;156;130;286
6;602;55;156;163;319
6;735;53;156;133;289
6;175;45;156;167;323
6;735;44;156;122;278
6;238;43;156;131;287
6;84;30;156;127;283
6;84;27;156;120;276
6;455;25;156;133;289
6;84;25;156;127;283
6;547;16;156;156;312
6;505;8;156;145;301
6;686;4;156;186;342
6;518;0;156;161;317
6;581;81;155;240;395
6;497;76;155;333;488
6;210;74;155;196;351
6;245;73;155;82;237
6;875;49;155;141;296
6;77;49;155;175;330
6;77;48;155;165;320
6;175;46;155;173;328
6;875;43;155;124;279
6;175;42;155;130;285
6;287;30;155;74;229
6;679;19;155;153;308
6;315;19;155;145;300
6;574;15;155;128;283
6;700;9;155;154;309
6;476;9;155;150;305
6;329;9;155;159;314
6;175;3;155;176;331
6;547;1;155;198;353
6;623;83;154;349;503
6;882;81;154;169;323
6;532;74;154;216;370
6;770;70;154;182;336
6;203;67;154;180;334
6;714;61;154;146;300
6;665;61;154;113;267
6;875;57;154;129;283
6;238;41;154;172;326
6;728;37;154;131;285
6;728;36;154;127;281
6;84;33;154;117;271
6;147;31;154;153;307
6;686;28;154;184;338
6;238;25;154;181;335
6;196;24;154;131;285
6;147;23;154;165;319
6;301;16;154;142;296
6;329;14;154;148;302
6;518;13;154;162;316
6;700;10;154;146;300
6;231;10;154;139;293
6;231;1;154;137;291
6;560;84;153;602;755
6;609;69;153;159;312
6;105;67;153;167;320
6;707;65;153;179;332
6;70;59;153;169;322
6;238;44;153;179;332
6;119;39;153;164;317
6;574;31;153;105;258
6;700;27;153;139;292
6;518;21;153;130;283
6;189;17;153;116;269
6;84;17;153;138;291
6;547;13;153;176;329
6;84;13;153;143;296
6;385;11;153;130;283
6;505;4;153;158;311
6;434;90;152;358;510
6;833;77;152;305;457
6;648;68;152;137;289
6;63;68;152;186;338
6;63;65;152;207;359
6;77;53;152;146;298
6;392;52;152;169;321
6;875;51;152;132;284
6;602;51;152;158;310
6;238;45;152;169;321
6;644;44;152;164;316
6;84;44;152;117;269
6;147;33;152;133;285
6;84;31;152;147;299
6;728;29;152;175;327
6;84;29;152;114;266
6;231;19;152;129;281
6;476;10;152;162;314
6;161;10;152;116;268
6;700;8;152;129;281
6;455;4;152;182;334
6;833;71;151;207;358
6;112;71;151;186;337
6;203;68;151;180;331
6;854;66;151;177;328
6;826;66;151;193;344
6;665;60;151;150;301
6;602;56;151;139;290
6;77;55;151;146;297
6;644;54;151;111;262
6;868;52;151;170;321
6;266;49;151;142;293
6;644;48;151;143;294
6;728;35;151;161;312
6;735;34;151;162;313
6;686;22;151;150;301
6;476;18;151;127;278
6;462;11;151;133;284
6;385;10;151;126;277
6;301;9;151;113;264
6;518;3;151;150;301
6;638;83;150;220;370
6;882;82;150;251;401
6;210;72;150;206;356
6;602;57;150;158;308
6;875;52;150;126;276
6;77;52;150;160;310
6;77;44;150;196;346
6;644;42;150;167;317
6;175;37;150;137;287
6;518;36;150;118;268
6;315;32;150;163;313
6;84;24;150;130;280
6;84;22;150;114;264
6;476;19;150;123;273
6;231;18;150;128;278
6;700;15;150;131;281
6;161;11;150;116;266
6;315;9;150;190;340
6;462;8;150;147;297
6;385;8;150;106;256
6;476;6;150;138;288
6;385;6;150;122;272
6;700;4;150;161;311
6;315;2;150;169;319
6;760;86;149;236;385
6;70;63;149;120;269
6;707;62;149;164;313
6;70;58;149;178;327
6;175;49;149;149;298
6;455;48;149;166;315
6;175;44;149;146;295
6;147;39;149;150;299
6;686;33;149;159;308
6;147;32;149;146;295
6;84;32;149;113;262
6;518;27;149;132;281
6;735;23;149;173;322
6;518;23;149;131;280
6;679;22;149;96;245
6;84;21;149;111;260
6;574;19;149;152;301
6;476;17;149;133;282
6;231;17;149;127;276
6;700;16;149;154;303
6;231;16;149;121;270
6;385;13;149;142;291
6;7;12;149;148;297
6;672;6;149;130;279
6;147;2;149;183;332
6;763;82;148;229;377
6;280;66;148;151;299
6;203;64;148;209;357
6;602;63;148;129;277
6;392;58;148;151;299
6;77;56;148;157;305
6;875;53;148;134;282
6;175;47;148;155;303
6;238;46;148;171;319
6;147;46;148;137;285
6;175;43;148;159;307
6;119;42;148;147;295
6;728;39;148;131;279
6;84;39;148;126;274
6;518;30;148;162;310
6;147;28;148;138;286
6;476;16;148;152;300
6;7;15;148;149;297
6;679;5;148;146;294
6;686;2;148;153;301
6;679;0;148;137;285
6;182;78;147;91;238
6;210;73;147;205;352
6;854;69;147;165;312
6;875;62;147;124;271
6;70;60;147;179;326
6;483;57;147;172;319
6;266;56;147;125;272
6;175;53;147;127;274
6;238;48;147;148;295
6;455;46;147;162;309
6;547;38;147;146;293
6;547;36;147;139;286
6;679;35;147;106;253
6;42;28;147;132;279
6;700;17;147;136;283
6;231;12;147;151;298
6;505;11;147;106;253
6;231;11;147;149;296
6;462;9;147;116;263
6;679;3;147;138;285
6;385;2;147;116;263
6;700;1;147;110;257
6;679;1;147;155;302
6;861;89;146;470;616
6;469;72;146;161;307
6;280;63;146;170;316
6;707;58;146;169;315
6;707;56;146;154;300
6;875;54;146;144;290
6;644;50;146;142;288
6;700;38;146;132;278
6;518;29;146;165;311
6;196;29;146;155;301
6;147;29;146;153;299
6;42;27;146;114;260
6;547;26;146;165;311
6;547;25;146;165;311
6;462;19;146;125;271
6;301;10;146;129;275
6;7;9;146;123;269
6;505;6;146;144;290
6;329;6;146;130;276
6;329;4;146;129;275
6;301;4;146;129;275
6;91;85;145;282;427
6;112;73;145;174;319
6;126;72;145;194;339
6;707;68;145;139;284
6;854;67;145;170;315
6;602;64;145;142;287
6;602;62;145;146;291
6;868;59;145;160;305
6;602;59;145;135;280
6;714;58;145;195;340
6;665;55;145;166;311
6;714;52;145;167;312
6;77;51;145;155;300
6;196;47;145;139;284
6;644;45;145;147;292
6;679;30;145;111;256
6;42;25;145;146;291
6;686;23;145;179;324
6;574;21;145;139;284
6;574;13;145;139;284
6;462;6;145;153;298
6;574;5;145;138;283
6;505;5;145;152;297
6;231;5;145;123;268
6;301;2;145;127;272
6;441;90;144;390;534
6;410;84;144;236;380
6;224;79;144;236;380
6;833;76;144;194;338
6;112;72;144;162;306
6;49;72;144;259;403
6;469;71;144;174;318
6;63;71;144;183;327
6;70;62;144;131;275
6;392;59;144;123;267
6;70;57;144;150;294
6;175;52;144;138;282
6;728;46;144;131;275
6;735;43;144;148;292
6;686;43;144;147;291
6;728;40;144;144;288
6;700;39;144;127;271
6;455;33;144;177;321
6;196;33;144;152;296
6;728;32;144;158;302
6;518;32;144;122;266
6;505;15;144;163;307
6;462;15;144;146;290
6;301;13;144;154;298
6;462;12;144;143;287
6;672;8;144;122;266
6;385;5;144;116;260
6;840;88;143;480;623
6;134;68;143;161;304
6;826;67;143;158;301
6;707;64;143;163;306
6;175;57;143;117;260
6;70;56;143;183;326
6;665;54;143;178;321
6;196;50;143;147;290
6;735;45;143;156;299
6;119;44;143;130;273
6;700;40;143;143;286
6;505;39;143;119;262
6;42;31;143;131;274
6;175;26;143;185;328
6;84;26;143;113;256
6;455;22;143;152;295
6;574;18;143;159;302
6;679;12;143;130;273
6;410;82;142;288;430
6;532;81;142;185;327
6;63;72;142;155;297
6;525;64;142;160;302
6;707;61;142;167;309
6;77;58;142;148;290
6;665;56;142;168;310
6;266;51;142;133;275
6;686;49;142;125;267
6;686;47;142;148;290
6;455;42;142;148;290
6;735;41;142;138;280
6;735;37;142;159;301
6;518;37;142;153;295
6;84;37;142;139;281
6;196;28;142;154;296
6;455;24;142;153;295
6;679;18;142;139;281
6;672;17;142;128;270
6;505;17;142;145;287
6;462;17;142;134;276
6;476;14;142;133;275
6;462;4;142;129;271
6;574;2;142;128;270
6;476;2;142;113;255
6;462;2;142;123;265
6;357;91;141;324;465
6;413;82;141;286;427
6;497;81;141;224;365
6;532;78;141;203;344
6;49;78;141;178;319
6;581;77;141;381;522
6;280;69;141;150;291
6;868;61;141;145;286
6;147;60;141;118;259
6;266;54;141;123;264
6;266;53;141;120;261
6;665;50;141;159;300
6;735;49;141;146;287
6;728;49;141;123;264
6;119;46;141;134;275
6;735;39;141;133;274
6;700;37;141;142;283
6;147;37;141;165;306
6;518;35;141;155;296
6;672;16;141;115;256
6;462;13;141;151;292
6;7;13;141;127;268
6;385;7;141;137;278
6;462;5;141;127;268
6;245;77;140;171;311
6;648;70;140;102;242
6;364;70;140;181;321
6;826;69;140;151;291
6;483;68;140;152;292
6;196;62;140;131;271
6;77;57;140;150;290
6;728;41;140;119;259
6;455;39;140;187;327
6;42;36;140;141;281
6;700;33;140;139;279
6;196;31;140;148;288
6;574;26;140;110;250
6;84;23;140;111;251
6;679;21;140;153;293
6;505;16;140;140;280
6;672;15;140;128;268
6;505;12;140;153;293
6;301;8;140;141;281
6;161;8;140;119;259
6;518;4;140;174;314
6;84;3;140;134;274
6;84;2;140;134;274
6;301;0;140;101;241
6;56;87;139;415;554
6;410;86;139;242;381
6;760;85;139;340;479
6;410;85;139;291;430
6;203;69;139;150;289
6;714;62;139;157;296
6;238;60;139;138;277
6;119;54;139;139;278
6;644;52;139;146;285
6;238;51;139;151;290
6;455;50;139;154;293
6;455;49;139;153;292
6;455;45;139;163;302
6;196;43;139;132;271
6;686;42;139;167;306
6;505;40;139;92;231
6;686;39;139;132;271
6;196;37;139;151;290
6;455;36;139;148;287
6;301;32;139;124;263
6;196;32;139;136;275
6;196;23;139;134;273
6;329;21;139;132;271
6;287;21;139;61;200
6;574;20;139;140;279
6;140;19;139;128;267
6;7;16;139;142;281
6;700;0;139;141;280
6;574;0;139;148;287
6;638;81;138;242;380
6;270;76;138;213;351
6;882;75;138;311;449
6;126;73;138;207;345
6;105;68;138;155;293
6;280;67;138;172;310
6;707;66;138;148;286
6;245;65;138;204;342
6;238;53;138;156;294
6;700;50;138;119;257
6;147;50;138;125;263
6;518;46;138;115;253
6;728;43;138;130;268
6;84;43;138;113;251
6;547;37;138;119;257
6;735;36;138;148;286
6;287;29;138;55;193
6;147;27;138;129;267
6;518;25;138;155;293
6;42;24;138;125;263
6;574;23;138;124;262
6;147;22;138;127;265
6;329;19;138;120;258
6;672;14;138;128;266
6;140;14;138;127;265
6;301;12;138;131;269
6;301;11;138;123;261
6;7;11;138;123;261
6;574;9;138;155;293
6;329;5;138;157;295
6;385;4;138;112;250
6;274;83;137;292;429
6;210;75;137;187;324
6;588;73;137;184;321
6;609;71;137;171;308
6;778;70;137;142;279
6;609;70;137;182;319
6;203;70;137;142;279
6;134;66;137;152;289
6;868;62;137;168;305
6;602;60;137;127;264
6;868;56;137;159;296
6;119;43;137;148;285
6;686;40;137;152;289
6;518;33;137;157;294
6;385;28;137;138;275
6;455;26;137;139;276
6;147;21;137;112;249
6;301;17;137;121;258
6;679;16;137;131;268
6;385;15;137;164;301
6;294;14;137;107;244
6;700;11;137;139;276
6;574;11;137;141;278
6;329;10;137;124;261
6;161;5;137;121;258
6;84;0;137;129;266
6;658;89;136;532;668
6;568;89;136;1006;1142
6;98;78;136;263;399
6;469;73;136;145;281
6;770;69;136;167;303
6;392;65;136;134;270
6;77;65;136;121;257
6;70;65;136;148;284
6;648;63;136;230;366
6;266;59;136;114;250
6;644;55;136;132;268
6;455;53;136;126;262
6;196;53;136;144;280
6;518;49;136;104;240
6;728;47;136;137;273
6;84;35;136;144;280
6;385;31;136;140;276
6;147;24;136;146;282
6;140;10;136;144;280
6;385;9;136;133;269
6;161;4;136;122;258
6;568;90;135;263;398
6;98;77;135;191;326
6;270;74;135;252;387
6;770;72;135;174;309
6;532;71;135;239;374
6;112;70;135;186;321
6;364;68;135;201;336
6;112;68;135;161;296
6;455;60;135;119;254
6;77;60;135;147;282
6;238;52;135;143;278
6;77;50;135;163;298
6;196;49;135;130;265
6;196;48;135;152;287
6;119;48;135;141;276
6;728;45;135;129;264
6;686;45;135;133;268
6;77;43;135;180;315
6;196;41;135;153;288
6;547;40;135;155;290
6;196;38;135;151;286
6;175;36;135;153;288
6;147;35;135;155;290
6;42;29;135;134;269
6;385;21;135;122;257
6;287;20;135;62;197
6;147;20;135;155;290
6;301;19;135;126;261
6;385;17;135;157;292
6;301;14;135;156;291
6;7;10;135;135;270
6;462;0;135;101;236
6;568;88;134;554;688
6;420;79;134;164;298
6;217;69;134;138;272
6;105;69;134;166;300
6;707;67;134;141;275
6;525;67;134;111;245
6;868;63;134;126;260
6;77;63;134;140;274
6;686;59;134;111;245
6;644;57;134;120;254
6;707;55;134;169;303
6;119;50;134;157;291
6;196;42;134;151;285
6;455;35;134;156;290
6;518;34;134;148;282
6;196;30;134;152;286
6;476;29;134;128;262
6;476;28;134;105;239
6;686;26;134;150;284
6;147;25;134;131;265
6;518;22;134;141;275
6;315;21;134;127;261
6;161;20;134;109;243
6;462;18;134;130;264
6;7;18;134;136;270
6;385;12;134;133;267
6;231;8;134;146;280
6;700;7;134;148;282
6;476;5;134;136;270
6;329;1;134;105;239
6;861;91;133;282;415
6;56;90;133;293;426
6;588;75;133;201;334
6;105;74;133;151;284
6;63;74;133;145;278
6;609;68;133;190;323
6;266;58;133;142;275
6;147;49;133;136;269
6;175;48;133;158;291
6;119;47;133;145;278
6;686;46;133;132;265
6;42;45;133;130;263
6;700;44;133;126;259
6;700;42;133;112;245
6;315;39;133;116;249
6;329;28;133;122;255
6;518;26;133;144;277
6;315;24;133;127;260
6;476;20;133;121;254
6;189;12;133;119;252
6;140;11;133;108;241
6;189;10;133;115;248
6;7;8;133;122;255
6;505;7;133;149;282
6;105;71;132;181;313
6;70;61;132;149;281
6;875;60;132;130;262
6;875;56;132;121;253
6;238;55;132;127;259
6;728;50;132;106;238
6;700;49;132;140;272
6;84;47;132;107;239
6;84;42;132;127;259
6;84;41;132;129;261
6;547;39;132;144;276
6;7;39;132;118;250
6;700;34;132;150;282
6;84;28;132;118;250
6;329;26;132;108;240
6;147;26;132;136;268
6;287;23;132;59;191
6;189;15;132;104;236
6;700;12;132;139;271
6;476;11;132;126;258
6;301;5;132;120;252
6;274;84;131;223;354
6;854;71;131;149;280
6;217;70;131;161;292
6;707;69;131;142;273
6;112;69;131;172;303
6;280;68;131;140;271
6;714;66;131;122;253
6;518;60;131;119;250
6;644;59;131;115;246
6;175;58;131;127;258
6;455;55;131;138;269
6;175;55;131;130;261
6;175;54;131;146;277
6;700;48;131;132;263
6;476;47;131;121;252
6;476;46;131;96;227
6;119;45;131;128;259
6;301;36;131;93;224
6;385;34;131;123;254
6;42;34;131;116;247
6;315;33;131;105;236
6;315;23;131;129;260
6;196;22;131;126;257
6;679;20;131;135;266
6;7;17;131;158;289
6;672;12;131;120;251
6;651;9;131;104;235
6;672;7;131;103;234
6;161;7;131;130;261
6;231;0;131;128;259
6;420;80;130;167;297
6;49;77;130;135;265
6;714;65;130;158;288
6;392;64;130;132;262
6;875;59;130;139;269
6;735;58;130;100;230
6;644;56;130;148;278
6;455;56;130;143;273
6;119;55;130;103;233
6;686;54;130;133;263
6;196;46;130;149;279
6;735;42;130;137;267
6;455;41;130;138;268
6;7;41;130;115;245
6;686;38;130;149;279
6;385;38;130;121;251
6;84;38;130;135;265
6;686;35;130;145;275
6;140;29;130;107;237
6;574;28;130;127;257
6;196;27;130;145;275
6;231;22;130;98;228
6;231;20;130;120;250
6;505;13;130;150;280
6;329;7;130;133;263
6;35;89;129;343;472
6;539;88;129;271;400
6;408;88;129;146;275
6;91;87;129;328;457
6;260;85;129;326;455
6;217;67;129;149;278
6;665;63;129;130;259
6;77;61;129;151;280
6;728;53;129;103;232
6;700;51;129;119;248
6;686;50;129;145;274
6;455;47;129;144;273
6;735;46;129;123;252
6;686;44;129;143;272
6;147;43;129;136;265
6;686;41;129;128;257
6;175;34;129;166;295
6;147;34;129;135;264
6;287;26;129;63;192
6;385;25;129;115;244
6;42;21;129;132;261
6;700;14;129;156;285
6;672;10;129;132;261
6;672;9;129;115;244
6;161;9;129;132;261
6;231;7;129;137;266
6;490;89;128;447;575
6;408;87;128;180;308
6;413;85;128;156;284
6;412;85;128;167;295
6;413;84;128;214;342
6;260;84;128;351;479
6;760;83;128;377;505
6;581;82;128;270;398
6;609;72;128;131;259
6;280;71;128;150;278
6;707;70;128;141;269
6;455;63;128;133;261
6;238;63;128;120;248
6;392;62;128;149;277
6;175;51;128;125;253
6;147;47;128;134;262
6;700;45;128;143;271
6;644;43;128;131;259
6;385;40;128;123;251
6;301;37;128;121;249
6;700;36;128;122;250
6;315;36;128;124;252
6;301;34;128;118;246
6;196;34;128;139;267
6;42;33;128;136;264
6;476;30;128;137;265
6;301;30;128;138;266
6;476;21;128;115;243
6;161;21;128;93;221
6;7;19;128;112;240
6;329;15;128;137;265
6;399;14;128;89;217
6;476;13;128;146;274
6;505;10;128;142;270
6;301;3;128;113;241
6;161;2;128;113;241
6;329;0;128;133;261
6;791;84;127;222;349
6;770;74;127;139;266
6;532;73;127;239;366
6;778;66;127;143;270
6;868;64;127;139;266
6;238;59;127;129;256
6;266;55;127;140;267
6;686;51;127;131;258
6;735;50;127;136;263
6;644;49;127;129;256
6;728;48;127;137;264
6;547;44;127;104;231
6;385;32;127;153;280
6;196;26;127;118;245
6;574;24;127;116;243
6;574;22;127;133;260
6;329;20;127;126;253
6;385;19;127;139;266
6;672;18;127;122;249
6;329;18;127;117;244
6;322;10;127;83;210
6;7;4;127;124;251
6;140;3;127;108;235
6;161;0;127;111;238
6;413;83;126;256;382
6;532;77;126;288;414
6;826;68;126;143;269
6;778;68;126;156;282
6;868;66;126;134;260
6;686;61;126;141;267
6;455;59;126;139;265
6;455;52;126;127;253
6;686;48;126;140;266
6;147;48;126;152;278
6;728;38;126;129;255
6;84;34;126;133;259
6;301;22;126;106;232
6;672;1;126;104;230
6;301;1;126;121;247
6;749;84;125;281;406
6;224;81;125;150;275
6;588;79;125;165;290
6;770;71;125;154;279
6;483;70;125;166;291
6;217;68;125;148;273
6;868;65;125;134;259
6;875;63;125;104;229
6;714;63;125;134;259
6;392;63;125;138;263
6;875;61;125;120;245
6;735;52;125;125;250
6;147;52;125;114;239
6;238;50;125;163;288
6;119;49;125;125;250
6;728;44;125;130;255
6;700;43;125;118;243
6;518;40;125;137;262
6;518;39;125;136;261
6;42;37;125;150;275
6;385;23;125;116;241
6;196;21;125;147;272
6;140;17;125;131;256
6;189;13;125;108;233
6;294;10;125;120;245
6;14;10;125;96;221
6;140;9;125;117;242
6;301;7;125;153;278
6;7;7;125;101;226
6;329;3;125;142;267
6;672;0;125;101;226
6;408;86;124;236;360
6;749;85;124;202;326
6;112;75;124;175;299
6;203;73;124;144;268
6;134;70;124;145;269
6;483;69;124;155;279
6;196;61;124;118;242
6;735;54;124;125;249
6;196;52;124;116;240
6;518;48;124;104;228
6;455;44;124;133;257
6;728;42;124;144;268
6;315;38;124;110;234
6;315;35;124;131;255
6;7;35;124;110;234
6;462;31;124;111;235
6;315;28;124;136;260
6;679;27;124;115;239
6;301;20;124;113;237
6;14;16;124;97;221
6;476;3;124;131;255
6;274;86;123;276;399
6;515;84;123;321;444
6;98;80;123;163;286
6;224;78;123;273;396
6;270;75;123;303;426
6;665;64;123;147;270
6;665;62;123;128;251
6;455;62;123;139;262
6;238;61;123;152;275
6;686;58;123;126;249
6;728;56;123;109;232
6;518;56;123;109;232
6;875;55;123;119;242
6;735;55;123;113;236
6;735;51;123;129;252
6;735;48;123;147;270
6;84;45;123;137;260
6;700;41;123;131;254
6;42;41;123;120;243
6;679;39;123;74;197
6;196;35;123;144;267
6;385;29;123;157;280
6;315;29;123;155;278
6;329;12;123;130;253
6;161;12;123;92;215
6;140;7;123;114;237
6;140;6;123;105;228
6;462;3;123;137;260
6;679;2;123;127;250
6;385;1;123;117;240
6;385;0;123;125;248
6;539;90;122;258;380
6;595;84;122;190;312
6;833;79;122;196;318
6;210;78;122;161;283
6;364;74;122;167;289
6;203;71;122;157;279
6;525;66;122;158;280
6;875;65;122;87;209
6;714;64;122;141;263
6;70;64;122;142;264
6;644;60;122;132;254
6;875;58;122;119;241
6;735;56;122;133;255
6;175;56;122;127;249
6;7;46;122;122;244
6;301;38;122;123;245
6;455;37;122;134;256
6;547;35;122;156;278
6;476;31;122;87;209
6;462;30;122;121;243
6;679;25;122;121;243
6;140;21;122;106;228
6;140;20;122;120;242
6;294;17;122;108;230
6;329;16;122;112;234
6;294;6;122;113;235
6;189;4;122;102;224
6;427;92;121;397;518
6;98;83;121;160;281
6;588;78;121;166;287
6;588;76;121;183;304
6;203;72;121;175;296
6;854;68;121;174;295
6;196;65;121;107;228
6;77;64;121;132;253
6;238;62;121;137;258
6;77;62;121;138;259
6;77;59;121;146;267
6;196;55;121;126;247
6;7;47;121;122;243
6;679;43;121;109;230
6;476;39;121;119;240
6;147;36;121;149;270
6;385;33;121;104;225
6;231;33;121;131;252
6;679;26;121;105;226
6;315;26;121;143;264
6;42;26;121;134;255
6;385;22;121;115;236
6;42;22;121;136;257
6;462;20;121;121;242
6;161;16;121;113;234
6;651;13;121;115;236
6;140;12;121;126;247
6;351;9;121;99;220
6;476;0;121;107;228
6;515;83;120;391;511
6;63;73;120;164;284
6;868;67;120;129;249
6;778;67;120;134;254
6;392;67;120;111;231
6;238;67;120;136;256
6;70;67;120;126;246
6;455;64;120;116;236
6;728;57;120;101;221
6;119;56;120;131;251
6;686;53;120;123;243
6;455;51;120;141;261
6;700;47;120;119;239
6;315;41;120;117;237
6;196;39;120;149;269
6;301;35;120;141;261
6;287;33;120;67;187
6;140;33;120;118;238
6;462;32;120;118;238
6;42;30;120;154;274
6;287;27;120;59;179
6;140;22;120;123;243
6;14;17;120;83;203
6;140;8;120;119;239
6;7;6;120;119;239
6;35;90;119;344;463
6;539;86;119;357;476
6;763;84;119;177;296
6;63;79;119;129;248
6;882;76;119;261;380
6;112;74;119;166;285
6;105;73;119;157;276
6;826;71;119;143;262
6;70;66;119;122;241
6;665;65;119;139;258
6;266;62;119;104;223
6;518;61;119;115;234
6;175;60;119;136;255
6;686;55;119;121;240
6;651;54;119;96;215
6;644;53;119;147;266
6;119;53;119;145;264
6;147;51;119;107;226
6;547;50;119;99;218
6;147;44;119;136;255
6;505;41;119;114;233
6;574;30;119;132;251
6;315;30;119;140;259
6;462;29;119;120;239
6;301;29;119;118;237
6;287;25;119;53;172
6;385;24;119;129;248
6;672;20;119;99;218
6;819;14;119;87;206
6;351;14;119;93;212
6;329;13;119;136;255
6;651;10;119;87;206
6;329;8;119;134;253
6;154;6;119;85;204
6;140;5;119;140;259
6;161;3;119;99;218
6;700;2;119;122;241
6;210;77;118;179;297
6;469;75;118;140;258
6;105;75;118;126;244
6;63;75;118;151;269
6;707;72;118;122;240
6;266;64;118;104;222
6;686;63;118;122;240
6;392;61;118;149;267
6;266;57;118;132;250
6;238;57;118;154;272
6;700;56;118;101;219
6;518;55;118;119;237
6;700;52;118;123;241
6;728;51;118;115;233
6;84;48;118;116;234
6;42;46;118;122;240
6;547;45;118;101;219
6;476;45;118;134;252
6;476;42;118;87;205
6;147;42;118;128;246
6;175;41;118;144;262
6;147;41;118;156;274
6;315;40;118;132;250
6;672;35;118;107;225
6;574;32;118;123;241
6;42;32;118;131;249
6;329;31;118;103;221
6;315;31;118;142;260
6;231;30;118;126;244
6;329;29;118;108;226
6;329;23;118;113;231
6;189;19;118;131;249
6;161;17;118;111;229
6;161;14;118;126;244
6;672;13;118;115;233
6;672;11;118;123;241
6;189;11;118;98;216
6;231;3;118;132;250
6;672;2;118;116;234
6;329;2;118;119;237
6;532;79;117;182;299
6;833;78;117;303;420
6;588;77;117;161;278
6;469;74;117;137;254
6;182;72;117;210;327
6;105;72;117;151;268
6;455;58;117;128;245
6;238;54;117;157;274
6;7;52;117;95;212
6;315;50;117;109;226
6;7;50;117;115;232
6;651;45;117;98;215
6;547;42;117;130;247
6;42;40;117;119;236
6;476;37;117;106;223
6;679;28;117;120;237
6;574;25;117;121;238
6;231;24;117;115;232
6;329;22;117;109;226
6;385;20;117;131;248
6;161;18;117;116;233
6;651;17;117;108;225
6;351;15;117;102;219
6;14;14;117;90;207
6;343;11;117;78;195
6;294;11;117;99;216
6;351;8;117;92;209
6;294;5;117;112;229
6;385;3;117;111;228
6;462;1;117;132;249
6;28;88;116;290;406
6;98;79;116;192;308
6;210;76;116;166;282
6;182;76;116;211;327
6;112;76;116;161;277
6;707;71;116;112;228
6;826;70;116;165;281
6;778;69;116;120;236
6;134;69;116;149;265
6;70;69;116;105;221
6;547;59;116;103;219
6;455;54;116;145;261
6;147;53;116;107;223
6;679;52;116;85;201
6;518;51;116;121;237
6;735;47;116;131;247
6;42;47;116;123;239
6;518;45;116;120;236
6;196;44;116;151;267
6;455;40;116;142;258
6;84;40;116;115;231
6;287;39;116;76;192
6;679;34;116;95;211
6;287;31;116;72;188
6;161;29;116;115;231
6;294;28;116;98;214
6;287;28;116;75;191
6;574;27;116;121;237
6;140;27;116;105;221
6;462;23;116;100;216
6;189;14;116;122;238
6;329;11;116;126;242
6;448;7;116;91;207
6;693;3;116;93;209
6;210;79;115;172;287
6;112;78;115;146;261
6;280;70;115;149;264
6;602;67;115;121;236
6;875;66;115;106;221
6;700;58;115;104;219
6;196;58;115;141;256
6;196;57;115;121;236
6;686;56;115;125;240
6;547;54;115;97;212
6;518;54;115;138;253
6;196;54;115;124;239
6;7;54;115;80;195
6;196;51;115;145;260
6;84;51;115;105;220
6;476;49;115;109;224
6;315;49;115;118;233
6;547;48;115;118;233
6;505;46;115;92;207
6;518;43;115;104;219
6;42;42;115;114;229
6;287;32;115;65;180
6;161;30;115;105;220
6;140;30;115;119;234
6;476;24;115;103;218
6;301;21;115;111;226
6;189;21;115;96;211
6;189;9;115;134;249
6;693;5;115;98;213
6;161;1;115;108;223
6;260;83;114;267;381
6;833;80;114;249;363
6;49;79;114;244;358
6;203;75;114;153;267
6;648;71;114;87;201
6;714;69;114;124;238
6;483;67;114;153;267
6;238;64;114;126;240
6;266;61;114;117;231
6;196;60;114;128;242
6;175;59;114;155;269
6;147;59;114;107;221
6;547;58;114;80;194
6;119;58;114;122;236
6;42;58;114;106;220
6;189;55;114;75;189
6;147;54;114;96;210
6;679;49;114;98;212
6;84;46;114;128;242
6;679;38;114;121;235
6;301;33;114;129;243
6;161;27;114;118;232
6;140;26;114;108;222
6;196;25;114;139;253
6;294;19;114;105;219
6;329;17;114;110;224
6;343;9;114;93;207
6;301;6;114;141;255
6;49;85;113;196;309
6;532;76;113;192;305
6;49;76;113;289;402
6;854;74;113;137;250
6;203;74;113;139;252
6;648;72;113;168;281
6;483;71;113;133;246
6;70;68;113;98;211
6;175;62;113;115;228
6;7;62;113;90;203
6;700;60;113;108;221
6;196;59;113;131;244
6;700;55;113;121;234
6;42;50;113;119;232
6;505;48;113;67;180
6;315;47;113;107;220
6;651;43;113;76;189
6;455;43;113;121;234
6;476;41;113;126;239
6;42;38;113;117;230
6;462;35;113;111;224
6;385;27;113;132;245
6;161;26;113;94;207
6;476;25;113;106;219
6;140;23;113;94;207
6;351;17;113;94;207
6;322;16;113;106;219
6;399;15;113;94;207
6;651;12;113;92;205
6;672;5;113;119;232
6;270;79;112;120;232
6;854;73;112;150;262
6;280;72;112;131;243
6;238;71;112;102;214
6;525;68;112;139;251
6;518;65;112;120;232
6;518;63;112;100;212
6;651;62;112;103;215
6;728;59;112;90;202
6;700;59;112;118;230
6;518;59;112;121;233
6;476;58;112;92;204
6;189;54;112;92;204
6;518;53;112;107;219
6;686;52;112;117;229
6;679;50;112;113;225
6;42;49;112;103;215
6;315;48;112;107;219
6;679;41;112;99;211
6;385;41;112;119;231
6;301;39;112;117;229
6;315;37;112;136;248
6;329;33;112;110;222
6;7;33;112;110;222
6;231;32;112;134;246
6;301;27;112;120;232
6;301;25;112;114;226
6;476;23;112;107;219
6;476;22;112;111;223
6;343;18;112;74;186
6;140;15;112;115;227
6;351;11;112;83;195
6;693;6;112;113;225
6;189;5;112;112;224
6;693;4;112;88;200
6;476;4;112;121;233
6;140;2;112;125;237
6;189;1;112;120;232
6;410;87;111;297;408
6;623;81;111;272;383
6;420;81;111;136;247
6;98;74;111;263;374
6;826;73;111;126;237
6;392;66;111;116;227
6;196;66;111;112;223
6;266;65;111;101;212
6;84;55;111;103;214
6;119;52;111;122;233
6;231;51;111;81;192
6;84;49;111;97;208
6;651;48;111;107;218
6;518;47;111;124;235
6;700;46;111;131;242
6;651;46;111;102;213
6;315;46;111;123;234
6;231;45;111;98;209
6;518;41;111;138;249
6;42;39;111;119;230
6;672;37;111;110;221
6;819;36;111;79;190
6;462;33;111;126;237
6;161;28;111;107;218
6;140;28;111;124;235
6;693;22;111;82;193
6;189;18;111;121;232
6;651;14;111;122;233
6;294;7;111;104;215
6;260;86;110;263;373
6;252;84;110;138;248
6;49;80;110;309;419
6;63;76;110;156;266
6;714;71;110;101;211
6;392;71;110;94;204
6;392;68;110;113;223
6;714;67;110;95;205
6;147;65;110;109;219
6;875;64;110;102;212
6;735;61;110;121;231
6;644;58;110;139;249
6;476;56;110;81;191
6;119;51;110;125;235
6;547;49;110;122;232
6;505;44;110;97;207
6;315;42;110;101;211
6;385;39;110;99;209
6;231;38;110;101;211
6;7;38;110;128;238
6;651;35;110;99;209
6;161;33;110;104;214
6;231;31;110;110;220
6;231;28;110;132;242
6;231;27;110;107;217
6;329;25;110;116;226
6;231;23;110;97;207
6;7;21;110;101;211
6;819;18;110;94;204
6;819;17;110;92;202
6;14;13;110;97;207
6;693;7;110;97;207
6;819;6;110;86;196
6;672;3;110;104;214
6;189;2;110;111;221
6;7;1;110;98;208
6;497;83;109;172;281
6;280;73;109;103;212
6;392;69;109;105;214
6;602;65;109;122;231
6;686;62;109;122;231
6;455;61;109;127;236
6;84;61;109;88;197
6;147;56;109;120;229
6;42;53;109;112;221
6;728;52;109;100;209
6;42;48;109;117;226
6;679;45;109;71;180
6;518;44;109;124;233
6;42;44;109;118;227
6;7;43;109;103;212
6;189;42;109;110;219
6;301;40;109;91;200
6;651;39;109;97;206
6;518;38;109;157;266
6;476;38;109;115;224
6;84;36;109;129;238
6;294;32;109;92;201
6;693;31;109;88;197
6;329;27;109;108;217
6;672;24;109;104;213
6;294;16;109;116;225
6;140;16;109;121;230
6;161;15;109;119;228
6;140;13;109;114;223
6;399;12;109;83;192
6;154;12;109;77;186
6;7;5;109;113;222
6;189;3;109;101;210
6;581;85;108;214;322
6;707;73;108;151;259
6;455;66;108;114;222
6;84;63;108;95;203
6;119;60;108;133;241
6;7;59;108;73;181
6;518;57;108;103;211
6;7;56;108;96;204
6;728;55;108;96;204
6;518;52;108;114;222
6;476;50;108;97;205
6;462;47;108;100;208
6;547;46;108;116;224
6;385;46;108;80;188
6;547;43;108;91;199
6;518;42;108;128;236
6;547;41;108;121;229
6;651;37;108;92;200
6;476;36;108;98;206
6;42;35;108;119;227
6;574;33;108;124;232
6;189;32;108;90;198
6;7;32;108;118;226
6;651;29;108;89;197
6;7;28;108;108;216
6;294;25;108;97;205
6;161;22;108;101;209
6;651;16;108;109;217
6;14;11;108;91;199
6;294;4;108;85;193
6;28;89;107;267;374
6;469;79;107;144;251
6;686;66;107;121;228
6;455;65;107;141;248
6;518;64;107;106;213
6;644;62;107;103;210
6;700;61;107;107;214
6;147;61;107;120;227
6;518;58;107;107;214
6;147;57;107;111;218
6;42;54;107;100;207
6;651;49;107;122;229
6;574;48;107;104;211
6;189;48;107;89;196
6;574;47;107;111;218
6;189;46;107;91;198
6;287;34;107;80;187
6;7;34;107;106;213
6;679;33;107;90;197
6;161;32;107;108;215
6;140;31;107;104;211
6;189;29;107;104;211
6;329;24;107;129;236
6;294;20;107;95;202
6;161;19;107;114;221
6;161;13;107;109;216
6;693;11;107;96;203
6;693;10;107;117;224
6;399;6;107;104;211
6;476;1;107;126;233
6;140;1;107;127;234
6;35;91;106;208;314
6;833;86;106;105;211
6;126;81;106;241;347
6;588;80;106;168;274
6;224;80;106;236;342
6;112;79;106;129;235
6;217;75;106;131;237
6;854;72;106;150;256
6;525;69;106;97;203
6;665;66;106;116;222
6;301;65;106;85;191
6;119;63;106;88;194
6;735;60;106;115;221
6;238;58;106;163;269
6;686;57;106;137;243
6;147;55;106;122;228
6;476;54;106;96;202
6;547;51;106;101;207
6;231;50;106;89;195
6;547;47;106;99;205
6;505;47;106;90;196
6;819;45;106;79;185
6;574;40;106;89;195
6;231;39;106;101;207
6;7;37;106;110;216
6;476;33;106;100;206
6;231;29;106;105;211
6;672;28;106;102;208
6;294;24;106;96;202
6;693;23;106;73;179
6;231;21;106;107;213
6;672;19;106;105;211
6;655;11;106;79;185
6;154;11;106;78;184
6;161;6;106;115;221
6;784;3;106;90;196
6;693;0;106;103;209
6;140;0;106;106;212
6;840;90;105;354;459
6;49;86;105;124;229
6;623;85;105;248;353
6;770;78;105;144;249
6;602;71;105;107;212
6;868;68;105;96;201
6;119;67;105;61;166
6;728;63;105;86;191
6;651;63;105;95;200
6;301;63;105;88;193
6;266;63;105;127;232
6;7;55;105;96;201
6;700;53;105;122;227
6;476;52;105;105;210
6;84;50;105;109;214
6;385;45;105;121;226
6;476;40;105;114;219
6;574;37;105;89;194
6;231;37;105;99;204
6;672;30;105;95;200
6;301;28;105;127;232
6;315;27;105;146;251
6;693;26;105;94;199
6;231;26;105;127;232
6;301;24;105;121;226
6;294;23;105;106;211
6;287;19;105;95;200
6;693;14;105;90;195
6;277;14;105;83;188
6;154;13;105;98;203
6;819;7;105;92;197
6;406;7;105;67;172
6;154;7;105;100;205
6;189;6;105;148;253
6;672;4;105;120;225
6;210;80;104;168;272
6;63;78;104;128;232
6;112;77;104;180;284
6;63;77;104;144;248
6;770;76;104;149;253
6;770;73;104;144;248
6;602;69;104;97;201
6;875;68;104;104;208
6;602;66;104;130;234
6;42;62;104;99;203
6;385;60;104;93;197
6;455;57;104;131;235
6;547;56;104;110;214
6;385;54;104;89;193
6;651;50;104;110;214
6;518;50;104;113;217
6;7;49;104;119;223
6;651;44;104;110;214
6;7;42;104;84;188
6;301;41;104;108;212
6;7;40;104;114;218
6;574;38;104;103;207
6;385;36;104;94;198
6;574;35;104;105;209
6;161;35;104;102;206
6;329;30;104;108;212
6;574;29;104;114;218
6;7;26;104;110;214
6;189;23;104;82;186
6;14;15;104;92;196
6;287;9;104;88;192
6;343;8;104;102;206
6;791;86;103;144;247
6;854;75;103;124;227
6;525;70;103;125;228
6;175;65;103;125;228
6;175;64;103;99;202
6;84;64;103;92;195
6;175;61;103;107;210
6;651;58;103;100;203
6;147;58;103;109;212
6;505;51;103;96;199
6;505;45;103;87;190
6;315;45;103;135;238
6;315;44;103;119;222
6;7;44;103;116;219
6;294;41;103;84;187
6;385;35;103;102;205
6;329;32;103;96;199
6;462;28;103;133;236
6;462;27;103;114;217
6;385;26;103;91;194
6;679;23;103;132;235
6;294;22;103;89;192
6;651;20;103;75;178
6;14;18;103;114;217
6;154;17;103;85;188
6;399;16;103;76;179
6;651;15;103;111;214
6;154;14;103;108;211
6;399;10;103;93;196
6;189;8;103;94;197
6;784;7;103;100;203
6;511;7;103;85;188
6;343;7;103;91;194
6;343;6;103;105;208
6;651;5;103;97;200
6;189;0;103;93;196
6;490;90;102;386;488
6;760;87;102;249;351
6;182;80;102;130;232
6;525;71;102;102;204
6;245;69;102;144;246
6;686;65;102;114;216
6;119;65;102;116;218
6;147;64;102;106;208
6;42;63;102;103;205
6;119;62;102;106;208
6;84;59;102;115;217
6;735;57;102;114;216
6;700;57;102;93;195
6;547;57;102;105;207
6;679;55;102;67;169
6;476;53;102;104;206
6;385;53;102;106;208
6;385;49;102;109;211
6;679;46;102;94;196
6;505;43;102;91;193
6;154;37;102;84;186
6;7;36;102;109;211
6;301;31;102;111;213
6;189;31;102;102;204
6;7;31;102;124;226
6;7;30;102;114;216
6;679;29;102;109;211
6;448;17;102;90;192
6;784;16;102;80;182
6;693;16;102;87;189
6;655;10;102;99;201
6;819;9;102;100;202
6;91;86;101;305;406
6;126;84;101;95;196
6;217;73;101;128;229
6;602;68;101;99;200
6;875;67;101;89;190
6;77;66;101;120;221
6;119;61;101;109;210
6;686;60;101;145;246
6;7;60;101;97;198
6;294;59;101;82;183
6;301;57;101;106;207
6;196;56;101;137;238
6;574;50;101;91;192
6;329;42;101;88;189
6;140;39;101;79;180
6;294;37;101;96;197
6;462;36;101;106;207
6;315;34;101;115;216
6;672;33;101;103;204
6;7;29;101;105;206
6;476;27;101;101;202
6;301;26;101;111;212
6;651;19;101;87;188
6;693;17;101;97;198
6;819;16;101;95;196
6;287;16;101;75;176
6;154;9;101;93;194
6;154;8;101;97;198
6;351;7;101;96;197
6;351;6;101;94;195
6;798;4;101;89;190
6;399;4;101;76;177
6;515;85;100;331;431
6;770;79;100;132;232
6;469;76;100;122;222
6;609;74;100;146;246
6;217;71;100;155;255
6;238;70;100;113;213
6;231;60;100;107;207
6;119;59;100;117;217
6;84;58;100;101;201
6;294;50;100;96;196
6;7;48;100;109;209
6;161;45;100;93;193
6;476;44;100;98;198
6;161;44;100;95;195
6;476;43;100;113;213
6;505;42;100;75;175
6;462;39;100;89;189
6;651;38;100;99;199
6;672;36;100;115;215
6;231;34;100;118;218
6;140;34;100;105;205
6;476;32;100;116;216
6;189;30;100;114;214
6;462;26;100;114;214
6;315;25;100;134;234
6;140;25;100;106;206
6;14;19;100;88;188
6;693;18;100;105;205
6;294;18;100;132;232
6;784;17;100;90;190
6;189;16;100;122;222
6;294;15;100;115;215
6;287;14;100;79;179
6;448;13;100;100;200
6;511;12;100;85;185
6;693;8;100;114;214
6;14;8;100;83;183
6;7;0;100;97;197
6;638;85;99;193;292
6;833;82;99;208;307
6;497;82;99;246;345
6;588;81;99;126;225
6;252;81;99;223;322
6;245;80;99;78;177
6;854;77;99;140;239
6;826;74;99;127;226
6;134;72;99;88;187
6;665;68;99;105;204
6;42;66;99;79;178
6;735;65;99;96;195
6;651;64;99;101;200
6;547;60;99;93;192
6;231;58;99;79;178
6;42;56;99;106;205
6;315;55;99;89;188
6;574;46;99;107;206
6;679;44;99;111;210
6;189;44;99;102;201
6;42;43;99;107;206
6;385;42;99;95;194
6;462;34;99;101;200
6;161;31;99;121;220
6;294;30;99;114;213
6;7;27;99;104;203
6;7;24;99;103;202
6;343;19;99;81;180
6;277;18;99;67;166
6;651;11;99;77;176
6;693;9;99;109;208
6;294;9;99;94;193
6;819;8;99;94;193
6;14;7;99;113;212
6;693;2;99;104;203
6;861;90;98;331;429
6;833;81;98;285;383
6;49;81;98;132;230
6;70;71;98;94;192
6;392;70;98;119;217
6;665;69;98;114;212
6;315;62;98;91;189
6;644;61;98;100;198
6;119;57;98;111;209
6;42;57;98;112;210
6;651;56;98;102;200
6;651;55;98;94;192
6;547;55;98;117;215
6;315;51;98;91;189
6;672;49;98;85;183
6;7;45;98;114;212
6;329;39;98;93;191
6;672;38;98;105;203
6;329;37;98;102;200
6;672;34;98;100;198
6;329;34;98;88;186
6;189;34;98;88;186
6;672;31;98;106;204
6;679;24;98;116;214
6;351;18;98;88;186
6;322;15;98;92;190
6;343;14;98;95;193
6;351;13;98;82;180
6;294;13;98;102;200
6;819;12;98;92;190
6;693;12;98;106;204
6;287;10;98;73;171
6;651;6;98;95;193
6;7;2;98;103;201
6;441;92;97;307;404
6;749;86;97;308;405
6;126;80;97;239;336
6;203;76;97;133;230
6;826;75;97;130;227
6;770;75;97;129;226
6;609;73;97;155;252
6;875;72;97;75;172
6;518;67;97;89;186
6;189;65;97;92;189
6;385;63;97;113;210
6;735;62;97;114;211
6;518;62;97;115;212
6;385;61;97;102;199
6;700;54;97;109;206
6;679;54;97;82;179
6;84;54;97;140;237
6;651;53;97;91;188
6;189;52;97;99;196
6;505;50;97;83;180
6;679;48;97;119;216
6;476;48;97;115;212
6;294;48;97;92;189
6;231;48;97;120;217
6;574;45;97;101;198
6;315;43;97;134;231
6;231;43;97;84;181
6;462;38;97;117;214
6;231;35;97;109;206
6;189;35;97;86;183
6;154;35;97;91;188
6;693;33;97;88;185
6;672;21;97;80;177
6;462;21;97;99;196
6;819;20;97;71;168
6;322;18;97;91;188
6;322;13;97;99;196
6;287;8;97;71;168
6;655;7;97;86;183
6;399;7;97;93;190
6;287;7;97;73;170
6;819;5;97;75;172
6;784;4;97;85;182
6;448;4;97;75;172
6;351;2;97;79;176
6;623;84;96;150;246
6;224;82;96;197;293
6;203;79;96;106;202
6;280;74;96;109;205
6;525;72;96;85;181
6;77;69;96;96;192
6;147;67;96;104;200
6;700;65;96;102;198
6;644;63;96;95;191
6;728;60;96;90;186
6;735;59;96;117;213
6;7;57;96;79;175
6;462;56;96;81;177
6;476;55;96;95;191
6;385;52;96;90;186
6;42;51;96;106;202
6;189;47;96;110;206
6;140;45;96;88;184
6;287;44;96;53;149
6;462;42;96;66;162
6;651;40;96;97;193
6;651;36;96;103;199
6;574;36;96;101;197
6;161;36;96;69;165
6;819;34;96;76;172
6;161;34;96;104;200
6;294;29;96;98;194
6;651;24;96;86;182
6;140;24;96;97;193
6;189;20;96;102;198
6;322;12;96;86;182
6;351;10;96;95;191
6;343;10;96;100;196
6;798;8;96;71;167
6;651;7;96;86;182
6;784;2;96;100;196
6;693;1;96;83;179
6;651;0;96;83;179
6;357;92;95;320;415
6;840;89;95;382;477
6;515;87;95;132;227
6;581;83;95;236;331
6;182;81;95;65;160
6;105;79;95;131;226
6;203;78;95;129;224
6;770;77;95;135;230
6;105;76;95;137;232
6;217;74;95;140;235
6;182;74;95;197;292
6;518;71;95;90;185
6;875;70;95;85;180
6;196;67;95;111;206
6;238;65;95;149;244
6;84;65;95;109;204
6;700;64;95;101;196
6;175;63;95;115;210
6;315;60;95;89;184
6;385;59;95;90;185
6;385;55;95;103;198
6;728;54;95;112;207
6;574;54;95;83;178
6;231;54;95;88;183
6;84;53;95;91;186
6;315;52;95;93;188
6;476;51;95;95;190
6;385;47;95;101;196
6;231;44;95;92;187
6;462;43;95;90;185
6;574;41;95;86;181
6;679;40;95;96;191
6;343;38;95;65;160
6;294;36;95;111;206
6;231;36;95;118;213
6;294;31;95;110;205
6;189;28;95;102;197
6;189;27;95;102;197
6;189;26;95;88;183
6;462;24;95;96;191
6;693;19;95;95;190
6;448;18;95;81;176
6;343;12;95;93;188
6;21;12;95;64;159
6;154;10;95;96;191
6;351;4;95;112;207
6;343;4;95;78;173
6;623;88;94;603;697
6;595;83;94;149;243
6;63;80;94;139;233
6;714;70;94;131;225
6;602;70;94;108;202
6;238;68;94;130;224
6;147;68;94;78;172
6;665;67;94;117;211
6;77;67;94;123;217
6;42;65;94;100;194
6;686;64;94;100;194
6;700;63;94;123;217
6;84;62;94;100;194
6;42;60;94;106;200
6;189;57;94;92;186
6;315;54;94;96;190
6;505;53;94;88;182
6;315;53;94;102;196
6;399;49;94;67;161
6;301;49;94;82;176
6;301;48;94;95;189
6;651;47;94;110;204
6;294;40;94;110;204
6;161;37;94;90;184
6;693;36;94;80;174
6;679;32;94;129;223
6;140;32;94;106;200
6;231;25;94;118;212
6;189;25;94;104;198
6;161;25;94;104;198
6;7;25;94;77;171
6;161;24;94;102;196
6;651;23;94;88;182
6;301;23;94;100;194
6;7;23;94;90;184
6;322;17;94;105;199
6;277;16;94;103;197
6;154;16;94;95;189
6;448;15;94;104;198
6;287;15;94;83;177
6;798;11;94;80;174
6;448;11;94;102;196
6;14;5;94;94;188
6;294;0;94;102;196
6;252;79;93;313;406
6;609;75;93;139;232
6;714;74;93;115;208
6;826;72;93;120;213
6;70;70;93;110;203
6;266;68;93;88;181
6;147;62;93;139;232
6;231;59;93;80;173
6;42;55;93;98;191
6;679;53;93;98;191
6;547;53;93;109;202
6;651;52;93;96;189
6;231;47;93;114;207
6;574;43;93;106;199
6;189;41;93;101;194
6;161;40;93;107;200
6;329;36;93;101;194
6;189;36;93;104;197
6;399;34;93;88;181
6;294;34;93;109;202
6;651;33;93;107;200
6;693;30;93;112;205
6;7;22;93;97;190
6;819;21;93;73;166
6;511;14;93;85;178
6;322;14;93;109;202
6;693;13;93;92;185
6;287;13;93;89;182
6;294;12;93;113;206
6;655;8;93;69;162
6;189;7;93;97;190
6;651;4;93;97;190
6;819;3;93;100;193
6;7;3;93;98;191
6;14;1;93;85;178
6;882;86;92;109;201
6;623;82;92;217;309
6;126;77;92;221;313
6;854;76;92;137;229
6;665;73;92;91;183
6;778;71;92;120;212
6;665;71;92;90;182
6;714;68;92;111;203
6;644;66;92;93;185
6;385;64;92;103;195
6;42;64;92;96;188
6;476;61;92;85;177
6;679;56;92;81;173
6;505;56;92;82;174
6;547;52;92;101;193
6;231;49;92;91;183
6;385;48;92;104;196
6;679;47;92;99;191
6;819;46;92;90;182
6;672;46;92;89;181
6;651;41;92;99;191
6;231;41;92;95;187
6;672;39;92;101;193
6;329;38;92;101;193
6;476;35;92;102;194
6;140;35;92;94;186
6;189;33;92;93;185
6;462;25;92;111;203
6;462;22;92;96;188
6;406;17;92;66;158
6;655;16;92;82;174
6;351;16;92;90;182
6;819;15;92;110;202
6;798;14;92;80;172
6;448;14;92;111;203
6;819;13;92;101;193
6;287;12;92;86;178
6;406;9;92;76;168
6;343;5;92;96;188
6;140;4;92;105;197
6;343;2;92;84;176
6;154;0;92;78;170
6;791;87;91;203;294
6;112;81;91;134;225
6;134;73;91;103;194
6;392;72;91;92;183
6;77;71;91;108;199
6;875;69;91;96;187
6;686;67;91;115;206
6;238;66;91;102;193
6;651;65;91;111;202
6;196;63;91;115;206
6;301;62;91;108;199
6;315;59;91;109;200
6;651;57;91;79;170
6;84;57;91;128;219
6;301;55;91;85;176
6;574;51;91;88;179
6;231;46;91;106;197
6;574;44;91;96;187
6;140;44;91;63;154
6;301;43;91;85;176
6;651;42;91;108;199
6;287;38;91;65;156
6;385;37;91;110;201
6;693;34;91;85;176
6;574;34;91;103;194
6;672;32;91;109;200
6;672;22;91;90;181
6;189;22;91;85;176
6;784;19;91;101;192
6;399;17;91;78;169
6;343;15;91;92;183
6;448;12;91;104;195
6;399;8;91;112;203
6;154;4;91;91;182
6;420;82;90;109;199
6;210;81;90;152;242
6;707;74;90;121;211
6;714;73;90;127;217
6;602;73;90;78;168
6;778;72;90;131;221
6;686;72;90;81;171
6;364;72;90;131;221
6;455;70;90;101;191
6;84;67;90;93;183
6;644;65;90;109;199
6;7;65;90;91;181
6;196;64;90;110;200
6;119;64;90;104;194
6;728;61;90;97;187
6;301;61;90;108;198
6;679;60;90;94;184
6;301;60;90;102;192
6;651;59;90;100;190
6;42;59;90;91;181
6;728;58;90;113;203
6;399;58;90;61;151
6;315;57;90;107;197
6;679;51;90;126;216
6;189;50;90;92;182
6;574;49;90;97;187
6;161;47;90;87;177
6;672;45;90;91;181
6;294;45;90;83;173
6;385;43;90;100;190
6;287;42;90;56;146
6;462;41;90;85;175
6;189;39;90;107;197
6;679;36;90;94;184
6;351;36;90;72;162
6;693;35;90;86;176
6;329;35;90;114;204
6;399;32;90;95;185
6;784;31;90;83;173
6;651;30;90;114;204
6;351;19;90;81;171
6;651;18;90;102;192
6;511;16;90;99;189
6;693;15;90;97;187
6;784;12;90;71;161
6;21;10;90;83;173
6;322;9;90;89;179
6;322;7;90;90;180
6;448;6;90;89;179
6;351;5;90;90;180
6;819;1;90;73;163
6;882;79;89;139;228
6;364;78;89;87;176
6;182;77;89;185;274
6;707;75;89;121;210
6;532;75;89;211;300
6;483;72;89;133;222
6;868;70;89;110;199
6;238;69;89;107;196
6;196;69;89;95;184
6;266;66;89;97;186
6;735;63;89;94;183
6;147;63;89;100;189
6;728;62;89;98;187
6;189;62;89;92;181
6;651;61;89;95;184
6;42;61;89;103;192
6;301;56;89;87;176
6;84;56;89;108;197
6;672;54;89;87;176
6;462;54;89;72;161
6;161;53;89;71;160
6;462;48;89;91;180
6;231;40;89;106;195
6;679;37;89;102;191
6;287;37;89;57;146
6;476;34;89;110;199
6;294;33;89;101;190
6;819;32;89;84;173
6;511;30;89;70;159
6;154;30;89;68;157
6;693;28;89;101;190
6;693;24;89;94;183
6;294;21;89;82;171
6;343;20;89;86;175
6;287;17;89;87;176
6;847;15;89;72;161
6;287;11;89;82;171
6;784;10;89;88;177
6;511;10;89;95;184
6;784;8;89;78;167
6;294;8;89;94;183
6;21;6;89;74;163
6;560;87;88;137;225
6;623;86;88;176;264
6;224;83;88;140;228
6;210;82;88;119;207
6;854;79;88;125;213
6;854;78;88;119;207
6;105;78;88;126;214
6;609;77;88;126;214
6;280;76;88;104;192
6;364;75;88;195;283
6;648;74;88;97;185
6;217;72;88;128;216
6;134;71;88;103;191
6;665;70;88;118;206
6;196;70;88;103;191
6;868;69;88;105;193
6;518;68;88;80;168
6;266;67;88;73;161
6;462;61;88;93;181
6;679;59;88;61;149
6;574;55;88;77;165
6;294;53;88;83;171
6;505;52;88;81;169
6;462;52;88;92;180
6;301;52;88;97;185
6;84;52;88;111;199
6;140;50;88;80;168
6;819;49;88;80;168
6;301;45;88;99;187
6;301;42;88;75;163
6;294;42;88;77;165
6;672;41;88;89;177
6;140;40;88;90;178
6;161;39;88;87;175
6;189;38;88;104;192
6;161;38;88;104;192
6;399;35;88;66;154
6;21;33;88;73;161
6;693;29;88;72;160
6;819;27;88;68;156
6;294;27;88;76;164
6;819;24;88;78;166
6;693;21;88;91;179
6;784;20;88;85;173
6;351;20;88;83;171
6;154;18;88;73;161
6;784;14;88;76;164
6;406;14;88;63;151
6;406;13;88;71;159
6;819;10;88;90;178
6;511;9;88;79;167
6;448;8;88;75;163
6;655;6;88;72;160
6;287;5;88;81;169
6;14;4;88;83;171
6;511;3;88;66;154
6;154;3;88;82;170
6;847;1;88;87;175
6;399;1;88;84;172
6;294;1;88;88;176
6;224;86;87;167;254
6;98;81;87;106;193
6;714;75;87;117;204
6;483;75;87;117;204
6;196;71;87;74;161
6;518;70;87;98;185
6;686;69;87;101;188
6;455;68;87;105;192
6;455;67;87;119;206
6;189;61;87;103;190
6;294;58;87;73;160
6;672;56;87;69;156
6;161;55;87;86;173
6;231;53;87;89;176
6;42;52;87;100;187
6;301;50;87;102;189
6;161;48;87;69;156
6;329;40;87;95;182
6;140;37;87;88;175
6;154;33;87;77;164
6;14;30;87;76;163
6;672;29;87;117;204
6;343;27;87;76;163
6;476;26;87;99;186
6;672;25;87;84;171
6;343;25;87;65;152
6;189;24;87;83;170
6;651;21;87;73;160
6;448;16;87;103;190
6;351;12;87;96;183
6;819;11;87;94;181
6;399;11;87;85;172
6;784;9;87;78;165
6;322;8;87;74;161
6;798;7;87;87;174
6;343;3;87;90;177
6;294;2;87;100;187
6;277;1;87;79;166
6;658;91;86;306;392
6;56;91;86;213;299
6;469;78;86;146;232
6;217;77;86;121;207
6;714;76;86;113;199
6;609;76;86;140;226
6;280;75;86;115;201
6;714;72;86;140;226
6;84;69;86;79;165
6;84;68;86;74;160
6;175;67;86;117;203
6;476;64;86;75;161
6;315;63;86;79;165
6;547;62;86;83;169
6;385;62;86;108;194
6;231;57;86;87;173
6;161;54;86;75;161
6;329;53;86;62;148
6;14;53;86;64;150
6;574;52;86;83;169
6;140;52;86;66;152
6;7;51;86;111;197
6;672;50;86;90;176
6;672;42;86;83;169
6;287;41;86;63;149
6;672;40;86;78;164
6;189;40;86;88;174
6;294;38;86;89;175
6;462;37;86;93;179
6;287;35;86;86;172
6;448;32;86;80;166
6;819;28;86;94;180
6;294;26;86;91;177
6;7;20;86;96;182
6;784;18;86;72;158
6;511;15;86;75;161
6;343;13;86;98;184
6;399;9;86;95;181
6;798;6;86;98;184
6;322;6;86;81;167
6;14;6;86;85;171
6;406;4;86;52;138
6;21;3;86;65;151
6;399;2;86;74;160
6;21;2;86;71;157
6;448;1;86;88;174
6;721;0;86;57;143
6;882;83;85;165;250
6;126;83;85;124;209
6;126;79;85;183;268
6;280;77;85;118;203
6;392;74;85;117;202
6;134;74;85;102;187
6;648;73;85;111;196
6;238;73;85;92;177
6;84;73;85;63;148
6;245;72;85;228;313
6;70;72;85;108;193
6;651;70;85;83;168
6;84;70;85;84;169
6;651;68;85;104;189
6;77;68;85;111;196
6;728;64;85;85;170
6;547;64;85;90;175
6;231;64;85;69;154
6;547;61;85;82;167
6;462;59;85;80;165
6;189;59;85;84;169
6;7;58;85;115;200
6;574;56;85;80;165
6;140;56;85;73;158
6;301;53;85;79;164
6;294;52;85;95;180
6;819;51;85;79;164
6;301;51;85;95;180
6;819;50;85;85;170
6;329;50;85;89;174
6;189;49;85;101;186
6;672;47;85;74;159
6;329;45;85;79;164
6;462;44;85;103;188
6;385;44;85;97;182
6;329;44;85;96;181
6;679;42;85;73;158
6;154;42;85;71;156
6;154;40;85;66;151
6;294;39;85;80;165
6;294;35;85;77;162
6;14;24;85;67;152
6;784;22;85;68;153
6;693;20;85;90;175
6;322;19;85;74;159
6;406;12;85;87;172
6;406;11;85;81;166
6;21;11;85;74;159
6;847;10;85;70;155
6;448;9;85;109;194
6;399;5;85;82;167
6;21;5;85;58;143
6;399;3;85;80;165
6;406;0;85;78;163
6;371;93;84;153;237
6;861;92;84;274;358
6;609;79;84;125;209
6;483;78;84;124;208
6;203;77;84;131;215
6;364;76;84;207;291
6;245;74;84;154;238
6;483;73;84;120;204
6;700;69;84;84;168
6;651;69;84;87;171
6;651;67;84;80;164
6;84;66;84;94;178
6;385;65;84;89;173
6;294;64;84;79;163
6;189;63;84;80;164
6;505;62;84;74;158
6;462;62;84;95;179
6;231;62;84;66;150
6;231;61;84;96;180
6;7;61;84;91;175
6;651;60;84;100;184
6;294;60;84;83;167
6;301;59;84;93;177
6;231;56;84;86;170
6;140;54;84;74;158
6;462;53;84;73;157
6;7;53;84;90;174
6;231;52;84;85;169
6;462;51;84;76;160
6;462;49;84;101;185
6;301;46;84;92;176
6;462;45;84;69;153
6;294;43;84;84;168
6;189;43;84;102;186
6;574;42;84;92;176
6;161;42;84;84;168
6;140;42;84;87;171
6;819;39;84;84;168
6;693;39;84;68;152
6;322;38;84;89;173
6;655;33;84;69;153
6;14;33;84;89;173
6;693;32;84;82;166
6;651;32;84;104;188
6;351;31;84;62;146
6;343;31;84;80;164
6;693;27;84;94;178
6;343;23;84;85;169
6;343;21;84;75;159
6;798;19;84;44;128
6;406;15;84;90;174
6;322;11;84;90;174
6;277;11;84;80;164
6;798;10;84;90;174
6;448;10;84;92;176
6;277;10;84;65;149
6;655;9;84;72;156
6;14;9;84;97;181
6;651;8;84;98;182
6;511;8;84;74;158
6;784;5;84;99;183
6;154;5;84;80;164
6;322;0;84;69;153
6;280;79;83;107;190
6;280;78;83;119;202
6;364;77;83;161;244
6;826;76;83;125;208
6;778;74;83;104;187
6;455;74;83;74;157
6;175;66;83;107;190
6;231;65;83;77;160
6;700;62;83;113;196
6;84;60;83;101;184
6;385;57;83;93;176
6;315;56;83;104;187
6;294;55;83;84;167
6;231;55;83;99;182
6;385;51;83;87;170
6;301;47;83;98;181
6;140;47;83;93;176
6;672;43;83;99;182
6;231;42;83;98;181
6;140;41;83;82;165
6;574;39;83;98;181
6;399;33;83;72;155
6;14;32;83;83;166
6;322;31;83;75;158
6;161;23;83;111;194
6;154;20;83;90;173
6;655;17;83;81;164
6;406;16;83;80;163
6;847;9;83;77;160
6;784;6;83;89;172
6;287;6;83;87;170
6;819;4;83;88;171
6;351;3;83;83;166
6;351;1;83;78;161
6;322;1;83;84;167
6;805;87;82;213;295
6;791;85;82;204;286
6;252;82;82;198;280
6;854;81;82;113;195
6;364;80;82;80;162
6;469;77;82;140;222
6;217;76;82;115;197
6;77;74;82;119;201
6;385;73;82;66;148
6;868;71;82;77;159
6;518;69;82;75;157
6;42;68;82;89;171
6;385;67;82;79;161
6;672;62;82;81;163
6;819;59;82;48;130
6;315;58;82;104;186
6;161;58;82;76;158
6;476;57;82;71;153
6;385;56;82;93;175
6;140;55;82;66;148
6;819;54;82;61;143
6;672;51;82;96;178
6;294;51;82;96;178
6;161;51;82;83;165
6;161;49;82;81;163
6;287;40;82;63;145
6;351;34;82;75;157
6;14;34;82;85;167
6;819;33;82;92;174
6;14;31;82;91;173
6;784;30;82;84;166
6;672;26;82;86;168
6;651;26;82;100;182
6;693;25;82;94;176
6;651;25;82;97;179
6;784;24;82;67;149
6;322;20;82;65;147
6;798;18;82;52;134
6;287;18;82;76;158
6;655;12;82;82;164
6;21;8;82;70;152
6;511;6;82;92;174
6;448;5;82;79;161
6;287;4;82;68;150
6;277;2;82;65;147
6;351;0;82;66;148
6;427;94;81;197;278
6;515;88;81;111;192
6;412;87;81;163;244
6;532;84;81;116;197
6;420;83;81;109;190
6;112;80;81;155;236
6;714;77;81;97;178
6;105;77;81;163;244
6;707;76;81;128;209
6;134;76;81;85;166
6;778;73;81;118;199
6;175;68;81;98;179
6;301;67;81;93;174
6;518;66;81;109;190
6;301;66;81;99;180
6;119;66;81;94;175
6;547;63;81;91;172
6;476;63;81;78;159
6;315;61;81;99;180
6;819;52;81;72;153
6;189;51;81;87;168
6;385;50;81;89;170
6;819;41;81;77;158
6;462;40;81;87;168
6;189;37;81;81;162
6;154;36;81;88;169
6;343;30;81;93;174
6;819;29;81;73;154
6;819;25;81;77;158
6;14;20;81;58;139
6;406;18;81;79;160
6;511;17;81;86;167
6;343;16;81;82;163
6;21;15;81;73;154
6;655;14;81;74;155
6;784;13;81;82;163
6;21;7;81;71;152
6;406;6;81;71;152
6;847;5;81;56;137
6;511;5;81;75;156
6;798;3;81;59;140
6;277;0;81;70;151
6;14;0;81;75;156
6;623;87;80;64;144
6;224;85;80;130;210
6;408;84;80;333;413
6;49;82;80;133;213
6;105;81;80;107;187
6;665;74;80;92;172
6;518;72;80;81;161
6;875;71;80;61;141
6;455;69;80;89;169
6;700;67;80;83;163
6;7;66;80;90;170
6;644;64;80;89;169
6;154;64;80;64;144
6;7;63;80;82;162
6;161;62;80;60;140
6;819;61;80;80;160
6;679;61;80;75;155
6;672;61;80;77;157
6;189;58;80;84;164
6;294;56;80;85;165
6;505;55;80;88;168
6;294;54;80;87;167
6;672;52;80;79;159
6;462;50;80;92;172
6;161;50;80;94;174
6;819;48;80;99;179
6;189;45;80;94;174
6;819;38;80;85;165
6;140;38;80;97;177
6;343;35;80;75;155
6;406;33;80;67;147
6;154;32;80;80;160
6;651;31;80;92;172
6;21;23;80;65;145
6;448;19;80;63;143
6;21;19;80;76;156
6;798;16;80;68;148
6;798;15;80;102;182
6;154;15;80;112;192
6;798;5;80;64;144
6;721;5;80;64;144
6;322;4;80;74;154
6;14;3;80;89;169
6;154;1;80;75;155
6;21;1;80;91;171
6;819;0;80;85;165
6;274;85;79;179;258
6;280;80;79;127;206
6;203;80;79;128;207
6;778;78;79;93;172
6;217;78;79;131;210
6;665;75;79;86;165
6;70;73;79;125;204
6;266;71;79;68;147
6;679;66;79;58;137
6;462;66;79;78;157
6;735;64;79;108;187
6;574;64;79;70;149
6;189;64;79;91;170
6;399;60;79;65;144
6;679;58;79;74;153
6;189;56;79;95;174
6;819;53;79;85;164
6;161;52;79;69;148
6;651;51;79;100;179
6;294;49;79;82;161
6;672;48;79;80;159
6;329;43;79;75;154
6;161;43;79;89;168
6;399;37;79;81;160
6;140;36;79;81;160
6;322;32;79;67;146
6;784;29;79;64;143
6;351;29;79;73;152
6;672;27;79;111;190
6;651;27;79;74;153
6;14;27;79;60;139
6;847;25;79;57;136
6;819;23;79;68;147
6;784;23;79;88;167
6;21;21;79;53;132
6;655;19;79;69;148
6;742;18;79;53;132
6;168;14;79;69;148
6;14;12;79;96;175
6;294;3;79;74;153
6;651;2;79;78;157
6;511;2;79;64;143
6;448;2;79;89;168
6;784;0;79;82;161
6;434;92;78;212;290
6;756;90;78;355;433
6;791;89;78;128;206
6;882;84;78;175;253
6;98;82;78;129;207
6;483;74;78;113;191
6;175;74;78;86;164
6;455;73;78;94;172
6;651;72;78;95;173
6;238;72;78;100;178
6;385;69;78;90;168
6;644;67;78;100;178
6;476;66;78;68;146
6;672;63;78;71;149
6;476;59;78;73;151
6;161;59;78;75;153
6;462;58;78;95;173
6;301;54;78;85;163
6;574;53;78;91;169
6;505;49;78;80;158
6;140;43;78;94;172
6;14;43;78;75;153
6;819;40;78;83;161
6;448;36;78;61;139
6;287;36;78;67;145
6;819;35;78;88;166
6;14;35;78;82;160
6;154;34;78;75;153
6;343;33;78;80;158
6;351;28;78;79;157
6;351;26;78;69;147
6;672;23;78;81;159
6;511;20;78;85;163
6;399;19;78;70;148
6;847;12;78;67;145
6;651;1;78;75;153
6;21;0;78;80;158
6;270;85;77;129;206
6;497;84;77;212;289
6;588;82;77;111;188
6;707;80;77;111;188
6;609;80;77;121;198
6;469;80;77;128;205
6;147;74;77;95;172
6;686;73;77;85;162
6;700;70;77;85;162
6;42;69;77;84;161
6;686;68;77;102;179
6;476;68;77;73;150
6;294;68;77;77;154
6;119;68;77;84;161
6;7;68;77;80;157
6;294;67;77;74;151
6;735;66;77;82;159
6;728;66;77;77;154
6;547;66;77;62;139
6;476;62;77;93;170
6;672;60;77;77;154
6;574;60;77;88;165
6;574;59;77;80;157
6;505;59;77;58;135
6;505;58;77;74;151
6;672;57;77;72;149
6;505;57;77;88;165
6;462;55;77;89;166
6;399;53;77;87;164
6;329;49;77;85;162
6;294;47;77;104;181
6;154;45;77;53;130
6;819;44;77;79;156
6;351;38;77;86;163
6;351;37;77;72;149
6;406;36;77;56;133
6;351;32;77;79;156
6;154;28;77;64;141
6;655;27;77;65;142
6;14;23;77;54;131
6;21;20;77;69;146
6;819;19;77;87;164
6;399;13;77;87;164
6;277;13;77;74;151
6;168;12;77;67;144
6;721;11;77;75;152
6;168;11;77;69;146
6;742;9;77;56;133
6;168;6;77;57;134
6;742;5;77;44;121
6;277;5;77;85;162
6;406;3;77;83;160
6;798;0;77;63;140
6;56;89;76;346;422
6;638;86;76;109;185
6;364;82;76;82;158
6;112;82;76;126;202
6;770;81;76;115;191
6;770;80;76;129;205
6;826;78;76;132;208
6;826;77;76;156;232
6;175;75;76;88;164
6;77;73;76;96;172
6;175;69;76;100;176
6;819;63;76;60;136
6;505;63;76;70;146
6;462;63;76;67;143
6;476;60;76;82;158
6;189;60;76;94;170
6;385;58;76;116;192
6;301;58;76;100;176
6;140;58;76;63;139
6;574;57;76;86;162
6;462;57;76;108;184
6;672;53;76;89;165
6;14;49;76;80;156
6;294;46;76;88;164
6;161;46;76;86;162
6;399;44;76;62;138
6;294;44;76;85;161
6;161;41;76;98;174
6;399;31;76;102;178
6;154;31;76;73;149
6;784;28;76;68;144
6;798;27;76;67;143
6;399;27;76;65;141
6;819;26;76;89;165
6;351;23;76;81;157
6;819;22;76;70;146
6;351;22;76;68;144
6;721;19;76;64;140
6;399;18;76;86;162
6;742;17;76;77;153
6;343;17;76;92;168
6;655;15;76;82;158
6;742;14;76;63;139
6;798;12;76;71;147
6;406;10;76;89;165
6;721;9;76;72;148
6;277;9;76;51;127
6;168;8;76;74;150
6;277;7;76;87;163
6;322;5;76;92;168
6;511;4;76;69;145
6;277;4;76;83;159
6;322;3;76;65;141
6;287;3;76;59;135
6;406;2;76;78;154
6;539;89;75;163;238
6;63;82;75;103;178
6;217;79;75;113;188
6;525;75;75;82;157
6;875;73;75;84;159
6;602;72;75;82;157
6;455;72;75;124;199
6;644;70;75;92;167
6;301;70;75;77;152
6;77;70;75;93;168
6;735;69;75;80;155
6;301;69;75;98;173
6;700;68;75;86;161
6;189;66;75;75;150
6;505;65;75;69;144
6;476;65;75;67;142
6;294;65;75;72;147
6;294;61;75;77;152
6;399;54;75;63;138
6;693;53;75;70;145
6;189;53;75;79;154
6;21;53;75;66;141
6;329;52;75;73;148
6;322;50;75;58;133
6;14;50;75;77;152
6;399;46;75;78;153
6;140;46;75;73;148
6;154;39;75;68;143
6;14;36;75;65;140
6;847;35;75;72;147
6;784;35;75;68;143
6;351;35;75;85;160
6;21;31;75;71;146
6;399;30;75;93;168
6;322;30;75;81;156
6;798;29;75;47;122
6;154;29;75;69;144
6;399;28;75;77;152
6;351;25;75;73;148
6;322;25;75;64;139
6;343;24;75;67;142
6;399;20;75;50;125
6;511;18;75;74;149
6;140;18;75;133;208
6;21;16;75;50;125
6;847;7;75;57;132
6;847;3;75;65;140
6;343;1;75;102;177
6;427;93;74;233;307
6;413;86;74;179;253
6;63;81;74;129;203
6;854;80;74;132;206
6;134;75;74;94;168
6;686;74;74;86;160
6;602;74;74;80;154
6;651;73;74;75;149
6;735;70;74;86;160
6;686;70;74;111;185
6;819;65;74;61;135
6;728;65;74;82;156
6;301;64;74;110;184
6;287;63;74;34;108
6;462;60;74;94;168
6;161;60;74;81;155
6;672;58;74;77;151
6;399;55;74;77;151
6;351;53;74;59;133
6;693;52;74;67;141
6;399;51;74;66;140
6;329;47;74;86;160
6;819;43;74;90;164
6;14;42;74;88;162
6;651;34;74;94;168
6;343;34;74;67;141
6;784;25;74;67;141
6;399;24;74;60;134
6;651;22;74;86;160
6;277;22;74;63;137
6;154;21;74;64;138
6;721;16;74;69;143
6;784;15;74;91;165
6;277;12;74;65;139
6;168;10;74;80;154
6;406;5;74;66;140
6;21;4;74;88;162
6;655;2;74;66;140
6;14;2;74;99;173
6;511;0;74;76;150
6;56;93;73;92;165
6;763;87;73;114;187
6;497;87;73;154;227
6;581;84;73;167;240
6;609;82;73;112;185
6;826;79;73;100;173
6;714;78;73;102;175
6;392;75;73;81;154
6;700;73;73;85;158
6;147;73;73;88;161
6;700;71;73;81;154
6;686;71;73;89;162
6;651;71;73;79;152
6;455;71;73;107;180
6;385;70;73;81;154
6;147;69;73;80;153
6;735;68;73;80;153
6;672;67;73;72;145
6;574;67;73;57;130
6;147;66;73;80;153
6;315;65;73;85;158
6;7;64;73;116;189
6;399;63;73;59;132
6;343;56;73;38;111
6;322;53;73;73;146
6;399;50;73;73;146
6;819;47;73;84;157
6;655;47;73;53;126
6;329;46;73;77;150
6;672;44;73;74;147
6;693;40;73;68;141
6;399;40;73;62;135
6;693;37;73;79;152
6;322;36;73;86;159
6;351;33;73;77;150
6;322;33;73;76;149
6;21;30;73;71;144
6;651;28;73;78;151
6;511;27;73;68;141
6;798;26;73;54;127
6;277;15;73;84;157
6;847;14;73;77;150
6;406;8;73;78;151
6;277;8;73;78;151
6;277;6;73;74;147
6;819;2;73;86;159
6;721;2;73;64;137
6;448;0;73;81;154
6;399;0;73;68;141
6;441;91;72;444;516
6;532;85;72;96;168
6;532;82;72;122;194
6;707;77;72;86;158
6;483;77;72;113;185
6;518;75;72;77;149
6;455;75;72;103;175
6;518;74;72;69;141
6;525;73;72;87;159
6;392;73;72;92;164
6;175;72;72;107;179
6;84;71;72;63;135
6;196;68;72;101;173
6;189;68;72;75;147
6;42;67;72;87;159
6;700;66;72;110;182
6;462;64;72;65;137
6;399;64;72;64;136
6;672;59;72;90;162
6;329;58;72;64;136
6;679;57;72;84;156
6;322;57;72;55;127
6;161;57;72;74;146
6;154;57;72;47;119
6;505;54;72;75;147
6;21;51;72;72;144
6;847;50;72;60;132
6;693;49;72;66;138
6;140;48;72;100;172
6;343;47;72;58;130
6;322;47;72;58;130
6;784;43;72;65;137
6;322;42;72;60;132
6;351;41;72;74;146
6;399;39;72;67;139
6;21;38;72;48;120
6;343;36;72;66;138
6;322;34;72;70;142
6;406;31;72;70;142
6;399;29;72;75;147
6;322;29;72;84;156
6;14;29;72;87;159
6;14;28;72;78;150
6;784;27;72;65;137
6;511;19;72;77;149
6;277;19;72;61;133
6;847;18;72;81;153
6;721;14;72;70;142
6;798;9;72;83;155
6;651;3;72;77;149
6;448;3;72;81;153
6;154;2;72;72;144
6;784;1;72;92;164
6;861;93;71;132;203
6;760;90;71;172;243
6;763;83;71;177;248
6;182;82;71;120;191
6;609;81;71;122;193
6;483;79;71;98;169
6;602;77;71;75;146
6;875;76;71;62;133
6;77;76;71;95;166
6;196;73;71;80;151
6;189;73;71;69;140
6;77;72;71;107;178
6;189;71;71;76;147
6;175;71;71;86;157
6;7;71;71;79;150
6;672;70;71;61;132
6;175;70;71;98;169
6;189;69;71;67;138
6;728;67;71;77;148
6;231;67;71;59;130
6;189;67;71;98;169
6;672;65;71;81;152
6;547;65;71;91;162
6;505;64;71;63;134
6;315;64;71;80;151
6;574;61;71;75;146
6;505;61;71;73;144
6;511;60;71;75;146
6;14;60;71;64;135
6;161;56;71;61;132
6;819;55;71;66;137
6;672;55;71;81;152
6;329;55;71;82;153
6;693;51;71;58;129
6;329;51;71;85;156
6;154;50;71;53;124
6;448;49;71;62;133
6;351;47;71;69;140
6;14;47;71;59;130
6;462;46;71;110;181
6;301;44;71;90;161
6;329;41;71;91;162
6;322;40;71;70;141
6;399;38;71;93;164
6;819;37;71;82;153
6;511;35;71;64;135
6;322;35;71;75;146
6;798;30;71;66;137
6;655;29;71;65;136
6;511;29;71;76;147
6;511;24;71;57;128
6;21;24;71;57;128
6;277;17;71;84;155
6;21;13;71;60;131
6;168;5;71;63;134
6;798;1;71;75;146
6;511;1;71;74;145
6;270;86;70;132;202
6;595;85;70;205;275
6;112;84;70;100;170
6;203;81;70;112;182
6;778;76;70;94;164
6;686;76;70;93;163
6;238;76;70;78;148
6;875;75;70;69;139
6;518;73;70;50;120
6;665;72;70;103;173
6;147;71;70;82;152
6;119;70;70;88;158
6;7;69;70;77;147
6;819;67;70;42;112
6;476;67;70;71;141
6;819;62;70;82;152
6;343;59;70;65;135
6;819;57;70;76;146
6;294;57;70;96;166
6;329;56;70;57;127
6;140;49;70;75;145
6;14;48;70;75;145
6;14;46;70;76;146
6;693;44;70;62;132
6;693;43;70;60;130
6;154;38;70;79;149
6;721;34;70;75;145
6;448;33;70;70;140
6;343;32;70;90;160
6;448;31;70;71;141
6;819;30;70;88;158
6;343;26;70;62;132
6;351;24;70;71;141
6;14;22;70;83;153
6;277;20;70;74;144
6;168;20;70;56;126
6;847;17;70;66;136
6;168;16;70;77;147
6;742;15;70;78;148
6;21;14;70;73;143
6;511;11;70;78;148
6;406;1;70;73;143
6;655;0;70;60;130
6;882;89;69;89;158
6;763;88;69;185;254
6;833;83;69;120;189
6;105;82;69;94;163
6;105;80;69;135;204
6;70;76;69;80;149
6;42;75;69;57;126
6;385;71;69;78;147
6;119;71;69;61;130
6;189;70;69;91;160
6;7;70;69;77;146
6;462;69;69;57;126
6;462;68;69;88;157
6;231;68;69;55;124
6;547;67;69;64;133
6;7;67;69;85;154
6;651;66;69;85;154
6;574;66;69;61;130
6;679;65;69;56;125
6;14;65;69;52;121
6;329;59;69;67;136
6;140;53;69;74;143
6;140;51;69;77;146
6;21;50;69;80;149
6;511;49;69;63;132
6;351;49;69;47;116
6;329;48;69;75;144
6;693;47;69;72;141
6;399;47;69;71;140
6;655;44;69;33;102
6;343;43;69;39;108
6;154;43;69;65;134
6;819;42;69;67;136
6;693;41;69;77;146
6;448;40;69;72;141
6;343;40;69;64;133
6;343;37;69;95;164
6;819;31;69;74;143
6;721;31;69;64;133
6;343;29;69;78;147
6;655;25;69;52;121
6;399;25;69;75;144
6;655;22;69;61;130
6;655;21;69;53;122
6;655;18;69;79;148
6;511;13;69;69;138
6;847;11;69;85;154
6;784;11;69;85;154
6;742;10;69;66;135
6;655;5;69;76;145
6;721;4;69;54;123
6;277;3;69;72;141
6;91;89;68;148;216
6;260;88;68;130;198
6;588;84;68;102;170
6;826;81;68;112;180
6;707;81;68;93;161
6;182;79;68;142;210
6;609;78;68;137;205
6;70;78;68;93;161
6;602;76;68;90;158
6;651;74;68;82;150
6;868;72;68;79;147
6;728;70;68;79;147
6;315;69;68;65;133
6;266;69;68;89;157
6;21;63;68;64;132
6;154;62;68;69;137
6;14;61;68;64;132
6;693;59;68;56;124
6;819;56;68;80;148
6;154;56;68;59;127
6;21;55;68;62;130
6;21;54;68;73;141
6;399;52;68;59;127
6;351;50;68;52;120
6;399;48;68;77;145
6;742;46;68;60;128
6;693;45;68;70;138
6;693;42;68;62;130
6;399;42;68;77;145
6;14;41;68;66;134
6;798;36;68;63;131
6;742;31;68;54;122
6;351;30;68;88;156
6;511;28;68;73;141
6;154;24;68;85;153
6;784;21;68;70;138
6;847;20;68;55;123
6;154;19;68;88;156
6;21;18;68;82;150
6;21;17;68;77;145
6;721;12;68;74;142
6;168;7;68;59;127
6;655;1;68;80;148
6;847;0;68;78;146
6;287;0;68;72;140
6;364;81;67;170;237
6;714;80;67;99;166
6;483;76;67;106;173
6;686;75;67;96;163
6;602;75;67;89;156
6;868;73;67;53;120
6;679;70;67;41;108
6;119;69;67;80;147
6;735;67;67;92;159
6;819;66;67;68;135
6;294;62;67;80;147
6;819;60;67;76;143
6;343;58;67;60;127
6;693;55;67;61;128
6;655;51;67;51;118
6;14;51;67;82;149
6;448;45;67;62;129
6;322;39;67;84;151
6;14;39;67;63;130
6;399;36;67;59;126
6;511;31;67;62;129
6;406;30;67;72;139
6;448;29;67;74;141
6;154;26;67;66;133
6;798;25;67;61;128
6;14;25;67;69;136
6;322;24;67;58;125
6;721;20;67;48;115
6;168;18;67;58;125
6;798;17;67;62;129
6;742;13;67;54;121
6;721;13;67;65;132
6;655;13;67;73;140
6;847;6;67;66;133
6;721;1;67;50;117
6;98;89;66;76;142
6;497;88;66;86;152
6;98;84;66;48;114
6;854;82;66;120;186
6;707;82;66;92;158
6;483;81;66;99;165
6;707;79;66;119;185
6;392;78;66;79;145
6;189;72;66;70;136
6;476;71;66;67;133
6;315;68;66;81;147
6;315;67;66;82;148
6;505;66;66;69;135
6;231;63;66;68;134
6;505;60;66;68;134
6;21;59;66;64;130
6;14;57;66;58;124
6;322;55;66;47;113
6;14;52;66;65;131
6;322;51;66;65;131
6;511;50;66;53;119
6;448;48;66;49;115
6;154;48;66;53;119
6;14;45;66;78;144
6;798;39;66;59;125
6;655;39;66;64;130
6;511;37;66;60;126
6;21;36;66;78;144
6;784;34;66;61;127
6;21;34;66;77;143
6;21;32;66;81;147
6;655;26;66;69;135
6;399;26;66;60;126
6;742;25;66;59;125
6;448;25;66;64;130
6;168;15;66;59;125
6;798;13;66;79;145
6;343;0;66;77;143
6;588;83;65;137;202
6;112;83;65;112;177
6;826;80;65;128;193
6;714;79;65;103;168
6;665;77;65;67;132
6;651;76;65;77;142
6;455;76;65;75;140
6;392;76;65;75;140
6;778;75;65;93;158
6;196;72;65;85;150
6;147;72;65;92;157
6;644;68;65;69;134
6;385;68;65;78;143
6;385;66;65;88;153
6;294;66;65;84;149
6;462;65;65;76;141
6;672;64;65;88;153
6;574;63;65;77;142
6;343;63;65;50;115
6;574;62;65;79;144
6;154;60;65;53;118
6;399;57;65;63;128
6;399;56;65;64;129
6;14;54;65;55;120
6;351;46;65;65;130
6;399;43;65;70;135
6;168;41;65;41;106
6;351;39;65;65;130
6;693;38;65;74;139
6;14;38;65;75;140
6;655;37;65;72;137
6;448;37;65;59;124
6;168;37;65;47;112
6;655;35;65;66;131
6;655;34;65;70;135
6;847;33;65;46;111
6;553;31;65;53;118
6;14;26;65;80;145
6;168;25;65;57;122
6;399;22;65;50;115
6;343;22;65;79;144
6;406;20;65;60;125
6;847;16;65;70;135
6;742;16;65;55;120
6;798;2;65;67;132
6;224;87;64;141;205
6;210;84;64;100;164
6;648;80;64;64;128
6;217;80;64;106;170
6;778;79;64;90;154
6;665;78;64;95;159
6;385;77;64;64;128
6;196;77;64;84;148
6;134;77;64;82;146
6;875;74;64;81;145
6;525;74;64;94;158
6;42;70;64;81;145
6;728;69;64;67;131
6;231;69;64;61;125
6;672;68;64;79;143
6;462;67;64;90;154
6;399;62;64;66;130
6;322;56;64;67;131
6;21;56;64;57;121
6;343;54;64;48;112
6;721;53;64;46;110
6;154;51;64;61;125
6;351;43;64;74;138
6;448;39;64;47;111
6;655;38;64;57;121
6;847;37;64;62;126
6;655;36;64;76;140
6;847;34;64;51;115
6;784;33;64;63;127
6;784;32;64;70;134
6;277;32;64;49;113
6;21;29;64;76;140
6;655;28;64;65;129
6;154;25;64;69;133
6;655;23;64;53;117
6;14;21;64;74;138
6;168;19;64;66;130
6;616;17;64;44;108
6;847;13;64;67;131
6;553;12;64;45;109
6;655;4;64;76;140
6;847;2;64;77;141
6;742;0;64;65;129
6;357;93;63;260;323
6;182;86;63;109;172
6;882;85;63;108;171
6;638;84;63;183;246
6;826;83;63;103;166
6;203;83;63;98;161
6;392;81;63;67;130
6;778;80;63;86;149
6;238;79;63;75;138
6;707;78;63;104;167
6;686;78;63;87;150
6;651;75;63;77;140
6;7;75;63;70;133
6;266;74;63;71;134
6;7;73;63;69;132
6;294;71;63;68;131
6;154;68;63;47;110
6;679;67;63;66;129
6;231;66;63;73;136
6;574;65;63;64;127
6;329;65;63;44;107
6;161;61;63;83;146
6;351;60;63;78;141
6;655;58;63;48;111
6;287;58;63;47;110
6;693;54;63;64;127
6;655;54;63;56;119
6;351;51;63;45;108
6;784;50;63;43;106
6;322;46;63;56;119
6;742;45;63;55;118
6;154;41;63;71;134
6;14;37;63;68;131
6;721;36;63;67;130
6;448;35;63;56;119
6;21;35;63;71;134
6;742;33;63;67;130
6;655;32;63;71;134
6;406;29;63;60;123
6;343;28;63;86;149
6;21;27;63;56;119
6;322;23;63;73;136
6;742;22;63;39;102
6;742;21;63;47;110
6;847;19;63;60;123
6;721;18;63;56;119
6;721;10;63;62;125
6;168;9;63;79;142
6;21;9;63;83;146
6;553;8;63;47;110
6;840;91;62;192;254
6;515;91;62;54;116
6;412;84;62;219;281
6;770;82;62;103;165
6;77;77;62;74;136
6;238;75;62;98;160
6;868;74;62;84;146
6;700;74;62;90;152
6;196;74;62;79;141
6;119;74;62;65;127
6;70;74;62;104;166
6;476;72;62;61;123
6;294;70;62;70;132
6;266;70;62;89;151
6;644;69;62;64;126
6;294;69;62;81;143
6;161;66;62;55;117
6;406;65;62;46;108
6;21;64;62;60;122
6;343;62;62;66;128
6;399;59;62;61;123
6;784;56;62;46;108
6;14;55;62;83;145
6;277;46;62;55;117
6;322;45;62;62;124
6;287;45;62;63;125
6;14;44;62;69;131
6;21;43;62;53;115
6;448;41;62;65;127
6;399;41;62;52;114
6;322;41;62;61;123
6;21;41;62;52;114
6;351;40;62;70;132
6;14;40;62;65;127
6;721;38;62;51;113
6;511;38;62;75;137
6;721;33;62;54;116
6;168;33;62;69;131
6;721;32;62;64;126
6;655;31;62;66;128
6;168;30;62;71;133
6;553;29;62;49;111
6;511;22;62;73;135
6;322;22;62;64;126
6;154;22;62;54;116
6;399;21;62;55;117
6;616;14;62;54;116
6;553;14;62;60;122
6;805;90;61;164;225
6;274;88;61;129;190
6;413;87;61;136;197
6;274;87;61;151;212
6;560;86;61;225;286
6;420;84;61;98;159
6;105;84;61;83;144
6;210;83;61;131;192
6;63;83;61;102;163
6;469;81;61;120;181
6;280;81;61;98;159
6;196;76;61;59;120
6;147;75;61;71;132
6;301;73;61;61;122
6;119;73;61;61;122
6;84;72;61;66;127
6;672;69;61;70;131
6;679;68;61;76;137
6;161;65;61;65;126
6;693;62;61;66;127
6;329;61;61;66;127
6;693;60;61;50;111
6;322;59;61;53;114
6;693;56;61;69;130
6;742;49;61;43;104
6;406;48;61;49;110
6;351;48;61;64;125
6;322;48;61;81;142
6;693;46;61;61;122
6;154;44;61;61;122
6;343;41;61;64;125
6;784;39;61;64;125
6;742;38;61;48;109
6;406;37;61;65;126
6;322;37;61;72;133
6;847;30;61;63;124
6;655;30;61;78;139
6;448;30;61;70;131
6;277;29;61;67;128
6;277;27;61;77;138
6;322;26;61;59;120
6;21;25;61;61;122
6;742;24;61;53;114
6;721;22;61;56;117
6;448;21;61;59;120
6;553;7;61;47;108
6;168;2;61;70;131
6;763;89;60;104;164
6;749;89;60;162;222
6;760;88;60;156;216
6;560;85;60;231;291
6;70;81;60;77;137
6;532;80;60;262;322
6;70;80;60;77;137
6;134;79;60;103;163
6;70;79;60;113;173
6;651;78;60;65;125
6;196;78;60;91;151
6;868;76;60;63;123
6;70;75;60;107;167
6;84;74;60;70;130
6;644;73;60;49;109
6;476;73;60;57;117
6;700;72;60;89;149
6;399;70;60;50;110
6;147;70;60;111;171
6;547;68;60;60;120
6;693;66;60;47;107
6;154;65;60;69;129
6;343;64;60;48;108
6;322;64;60;49;109
6;329;62;60;59;119
6;140;62;60;56;116
6;847;60;60;61;121
6;140;60;60;65;125
6;693;58;60;72;132
6;574;58;60;69;129
6;21;58;60;76;136
6;140;57;60;76;136
6;21;57;60;63;123
6;14;56;60;63;123
6;343;52;60;56;116
6;406;49;60;64;124
6;343;49;60;83;143
6;784;48;60;53;113
6;399;45;60;67;127
6;287;43;60;57;117
6;655;40;60;65;125
6;448;38;60;65;125
6;511;34;60;70;130
6;847;31;60;46;106
6;742;29;60;48;108
6;322;28;60;87;147
6;406;26;60;59;119
6;721;24;60;49;109
6;277;24;60;37;97
6;742;23;60;55;115
6;511;23;60;70;130
6;399;23;60;65;125
6;742;19;60;68;128
6;616;16;60;49;109
6;168;13;60;80;140
6;655;3;60;66;126
6;287;1;60;65;125
6;490;91;59;242;301
6;274;90;59;86;145
6;252;83;59;189;248
6;483;80;59;89;148
6;134;80;59;87;146
6;147;77;59;54;113
6;665;76;59;76;135
6;147;76;59;54;113
6;238;74;59;100;159
6;728;73;59;76;135
6;644;72;59;53;112
6;294;72;59;70;129
6;7;72;59;86;145
6;644;71;59;70;129
6;672;66;59;80;139
6;322;65;59;52;111
6;140;65;59;73;132
6;14;64;59;73;132
6;351;61;59;65;124
6;343;61;59;51;110
6;329;60;59;69;128
6;351;59;59;69;128
6;322;58;59;67;126
6;14;58;59;62;121
6;351;57;59;52;111
6;329;54;59;84;143
6;154;52;59;70;129
6;693;50;59;70;129
6;287;50;59;58;117
6;847;49;59;46;105
6;322;49;59;51;110
6;287;48;59;50;109
6;277;48;59;47;106
6;154;46;59;66;125
6;721;45;59;47;106
6;448;44;59;65;124
6;406;43;59;40;99
6;351;42;59;62;121
6;784;40;59;57;116
6;511;39;59;64;123
6;277;37;59;58;117
6;277;36;59;59;118
6;406;35;59;63;122
6;168;35;59;71;130
6;553;34;59;50;109
6;448;34;59;73;132
6;168;28;59;56;115
6;21;28;59;71;130
6;322;27;59;79;138
6;847;22;59;59;118
6;168;22;59;64;123
6;511;21;59;62;121
6;351;21;59;73;132
6;655;20;59;66;125
6;406;19;59;56;115
6;721;15;59;76;135
6;721;6;59;72;131
6;847;4;59;68;127
6;322;2;59;73;132
6;91;91;58;103;161
6;280;83;58;78;136
6;280;82;58;87;145
6;476;80;58;51;109
6;294;76;58;77;135
6;7;76;58;58;116
6;266;75;58;61;119
6;77;75;58;81;139
6;42;73;58;85;143
6;385;72;58;80;138
6;547;70;58;74;132
6;406;66;58;43;101
6;679;63;58;64;122
6;154;61;58;65;123
6;287;59;58;61;119
6;168;59;58;28;86
6;140;59;58;51;109
6;154;58;58;62;120
6;154;55;58;58;116
6;154;54;58;51;109
6;351;52;58;57;115
6;448;50;58;49;107
6;343;48;58;48;106
6;448;46;58;58;116
6;287;46;58;45;103
6;322;44;58;66;124
6;798;42;58;47;105
6;721;42;58;57;115
6;742;39;58;51;109
6;406;39;58;70;128
6;21;39;58;61;119
6;798;35;58;56;114
6;406;32;58;67;125
6;277;28;58;58;116
6;847;27;58;55;113
6;406;27;58;71;129
6;154;27;58;73;131
6;511;25;58;72;130
6;655;24;58;61;119
6;154;23;58;53;111
6;277;21;58;59;117
6;847;8;58;56;114
6;833;84;57;137;194
6;686;79;57;97;154
6;648;77;57;41;98
6;525;76;57;72;129
6;735;75;57;88;145
6;294;75;57;72;129
6;196;75;57;85;142
6;462;73;57;90;147
6;266;72;57;62;119
6;315;71;57;75;132
6;679;69;57;37;94
6;476;69;57;61;118
6;351;66;57;46;103
6;14;63;57;75;132
6;448;55;57;54;111
6;343;55;57;70;127
6;21;48;57;70;127
6;847;47;57;58;115
6;448;47;57;79;136
6;655;46;57;58;115
6;511;46;57;57;114
6;21;45;57;69;126
6;343;44;57;56;113
6;742;43;57;47;104
6;406;42;57;47;104
6;277;42;57;40;97
6;21;42;57;61;118
6;343;39;57;73;130
6;847;38;57;58;115
6;553;35;57;43;100
6;511;33;57;58;115
6;798;28;57;71;128
6;406;22;57;49;106
6;322;21;57;59;116
6;798;20;57;71;128
6;721;17;57;67;124
6;616;15;57;48;105
6;742;7;57;69;126
6;168;4;57;53;110
6;742;2;57;51;108
6;742;1;57;61;118
6;658;93;56;81;137
6;35;92;56;100;156
6;581;88;56;143;199
6;595;86;56;104;160
6;112;85;56;114;170
6;105;83;56;95;151
6;826;82;56;105;161
6;175;79;56;89;145
6;175;77;56;65;121
6;70;77;56;85;141
6;84;75;56;63;119
6;385;74;56;83;139
6;505;73;56;47;103
6;42;71;56;84;140
6;505;68;56;51;107
6;448;66;56;54;110
6;693;64;56;54;110
6;329;64;56;58;114
6;511;63;56;60;116
6;322;63;56;49;105
6;655;62;56;55;111
6;721;61;56;43;99
6;784;55;56;41;97
6;351;54;56;66;122
6;322;54;56;52;108
6;784;53;56;54;110
6;721;50;56;62;118
6;21;49;56;82;138
6;287;47;56;56;112
6;721;46;56;71;127
6;406;44;56;55;111
6;655;43;56;47;103
6;742;42;56;45;101
6;511;42;56;61;117
6;655;41;56;67;123
6;277;40;56;63;119
6;798;38;56;71;127
6;798;37;56;52;108
6;784;37;56;61;117
6;784;36;56;60;116
6;277;31;56;66;122
6;721;30;56;65;121
6;616;30;56;54;110
6;847;28;56;61;117
6;721;28;56;64;120
6;406;28;56;64;120
6;277;26;56;48;104
6;721;25;56;44;100
6;277;23;56;50;106
6;847;21;56;54;110
6;553;19;56;50;106
6;742;12;56;67;123
6;742;11;56;59;115
6;287;2;56;70;126
6;581;89;55;82;137
6;833;87;55;108;163
6;581;87;55;119;174
6;469;83;55;98;153
6;686;80;55;79;134
6;700;79;55;76;131
6;455;79;55;87;142
6;364;79;55;176;231
6;245;79;55;117;172
6;700;78;55;83;138
6;238;78;55;84;139
6;651;77;55;73;128
6;455;77;55;53;108
6;868;75;55;68;123
6;42;74;55;70;125
6;175;73;55;89;144
6;735;72;55;80;135
6;462;72;55;67;122
6;42;72;55;69;124
6;231;71;55;59;114
6;476;70;55;67;122
6;693;65;55;53;108
6;14;62;55;70;125
6;693;61;55;57;112
6;21;61;55;68;123
6;742;60;55;47;102
6;819;58;55;80;135
6;784;57;55;52;107
6;329;57;55;70;125
6;287;55;55;50;105
6;448;53;55;49;104
6;287;52;55;46;101
6;406;51;55;55;110
6;798;49;55;48;103
6;721;48;55;45;100
6;693;48;55;59;114
6;351;45;55;59;114
6;168;45;55;56;111
6;798;44;55;49;104
6;742;35;55;61;116
6;798;34;55;60;115
6;406;34;55;81;136
6;277;34;55;51;106
6;168;31;55;60;115
6;448;24;55;54;109
6;553;3;55;59;114
6;168;3;55;54;109
6;553;0;55;35;90
6;441;93;54;258;312
6;56;92;54;193;247
6;532;87;54;42;96
6;588;85;54;108;162
6;63;84;54;106;160
6;875;80;54;55;109
6;392;80;54;81;135
6;665;79;54;64;118
6;875;78;54;68;122
6;455;78;54;88;142
6;778;77;54;96;150
6;700;77;54;75;129
6;7;77;54;46;100
6;294;74;54;56;110
6;189;74;54;78;132
6;672;72;54;43;97
6;728;71;54;75;129
6;161;69;54;58;112
6;351;65;54;50;104
6;343;65;54;56;110
6;511;62;54;46;100
6;399;61;54;78;132
6;343;60;54;54;108
6;406;59;54;49;103
6;655;57;54;51;105
6;406;57;54;57;111
6;277;55;54;40;94
6;448;54;54;51;105
6;655;53;54;52;106
6;343;53;54;70;124
6;655;50;54;54;108
6;168;48;54;41;95
6;406;47;54;65;119
6;154;47;54;62;116
6;21;47;54;59;113
6;798;46;54;56;110
6;784;46;54;54;108
6;168;46;54;37;91
6;798;45;54;46;100
6;721;43;54;48;102
6;655;42;54;70;124
6;277;41;54;54;108
6;847;39;54;68;122
6;721;35;54;58;112
6;721;26;54;62;116
6;406;24;54;52;106
6;21;22;54;62;116
6;448;20;54;57;111
6;553;17;54;43;97
6;553;13;54;46;100
6;721;7;54;70;124
6;742;6;54;56;110
6;742;4;54;50;104
6;168;1;54;55;109
6;840;93;53;137;190
6;805;92;53;79;132
6;490;92;53;171;224
6;412;86;53;95;148
6;420;85;53;64;117
6;364;85;53;90;143
6;203;85;53;73;126
6;98;85;53;145;198
6;609;84;53;92;145
6;770;83;53;94;147
6;483;82;53;95;148
6;469;82;53;121;174
6;686;81;53;78;131
6;455;80;53;73;126
6;294;78;53;50;103
6;175;78;53;76;129
6;134;78;53;96;149
6;686;77;53;84;137
6;42;77;53;57;110
6;728;75;53;64;117
6;301;74;53;55;108
6;7;74;53;62;115
6;294;73;53;55;108
6;301;72;53;82;135
6;21;71;53;66;119
6;399;69;53;51;104
6;406;68;53;30;83
6;399;68;53;41;94
6;351;68;53;47;100
6;315;66;53;104;157
6;399;65;53;70;123
6;287;65;53;46;99
6;329;63;53;67;120
6;294;63;53;68;121
6;161;63;53;66;119
6;448;62;53;45;98
6;655;60;53;48;101
6;14;59;53;76;129
6;351;58;53;69;122
6;693;57;53;54;107
6;351;55;53;56;109
6;511;51;53;70;123
6;448;51;53;64;117
6;343;51;53;51;104
6;798;50;53;44;97
6;343;50;53;64;117
6;287;49;53;53;106
6;655;48;53;57;110
6;406;45;53;44;97
6;277;44;53;48;101
6;21;44;53;64;117
6;798;43;53;53;106
6;277;43;53;53;106
6;721;40;53;62;115
6;168;40;53;65;118
6;277;38;53;55;108
6;21;37;53;53;106
6;742;36;53;60;113
6;721;29;53;62;115
6;351;27;53;68;121
6;406;25;53;46;99
6;406;23;53;48;101
6;616;13;53;55;108
6;553;11;53;35;88
6;742;8;53;72;125
6;553;6;53;56;109
6;553;4;53;47;100
6;434;94;52;145;197
6;658;92;52;224;276
6;412;88;52;117;169
6;134;82;52;53;105
6;126;82;52;118;170
6;77;79;52;74;126
6;602;78;52;71;123
6;868;77;52;69;121
6;462;77;52;57;109
6;735;76;52;60;112
6;700;76;52;74;126
6;518;76;52;64;116
6;728;74;52;58;110
6;672;73;52;73;125
6;819;72;52;46;98
6;847;68;52;36;88
6;301;68;52;80;132
6;140;66;52;56;108
6;448;65;52;54;106
6;161;64;52;61;113
6;140;64;52;55;107
6;351;63;52;61;113
6;798;62;52;47;99
6;21;62;52;57;109
6;511;61;52;52;104
6;721;60;52;45;97
6;287;60;52;51;103
6;277;60;52;60;112
6;511;59;52;66;118
6;721;56;52;39;91
6;287;56;52;40;92
6;784;54;52;49;101
6;798;52;52;50;102
6;322;52;52;69;121
6;277;51;52;49;101
6;721;49;52;62;114
6;784;45;52;54;106
6;343;45;52;59;111
6;742;44;52;44;96
6;21;40;52;54;106
6;553;38;52;57;109
6;847;32;52;61;113
6;168;32;52;62;114
6;277;25;52;44;96
6;798;23;52;60;112
6;616;11;52;35;87
6;616;10;52;52;104
6;553;9;52;55;107
6;427;95;51;109;160
6;568;91;51;159;210
6;638;89;51;69;120
6;270;87;51;126;177
6;497;86;51;176;227
6;98;86;51;134;185
6;497;85;51;143;194
6;469;84;51;94;145
6;648;83;51;44;95
6;714;82;51;94;145
6;665;80;51;74;125
6;875;79;51;58;109
6;189;79;51;57;108
6;875;77;51;69;120
6;84;76;51;63;114
6;189;75;51;64;115
6;462;74;51;70;121
6;735;71;51;72;123
6;679;71;51;62;113
6;462;70;51;68;119
6;315;70;51;75;126
6;140;70;51;68;119
6;154;69;51;56;107
6;728;68;51;87;138
6;574;68;51;57;108
6;154;66;51;51;102
6;351;64;51;50;101
6;322;61;51;58;109
6;721;59;51;44;95
6;511;57;51;52;103
6;277;57;51;48;99
6;742;55;51;55;106
6;655;55;51;47;98
6;742;54;51;39;90
6;511;54;51;50;101
6;154;53;51;59;110
6;847;51;51;49;100
6;784;51;51;58;109
6;168;51;51;42;93
6;277;50;51;53;104
6;154;49;51;89;140
6;511;47;51;65;116
6;277;47;51;54;105
6;351;44;51;58;109
6;448;43;51;51;102
6;322;43;51;68;119
6;784;42;51;46;97
6;277;39;51;63;114
6;742;34;51;56;107
6;798;33;51;69;120
6;511;32;51;79;130
6;742;28;51;59;110
6;553;28;51;37;88
6;168;24;51;47;98
6;798;21;51;70;121
6;742;20;51;57;108
6;168;17;51;77;128
6;553;10;51;48;99
6;553;1;51;45;96
6;28;92;50;165;215
6;408;89;50;119;169
6;595;88;50;89;139
6;410;88;50;254;304
6;224;88;50;139;189
6;49;87;50;117;167
6;126;86;50;103;153
6;854;85;50;82;132
6;469;85;50;87;137
6;854;83;50;89;139
6;875;82;50;51;101
6;270;82;50;53;103
6;203;82;50;94;144
6;77;81;50;80;130
6;525;80;50;60;110
6;77;80;50;98;148
6;651;79;50;79;129
6;462;79;50;53;103
6;196;79;50;78;128
6;525;78;50;89;139
6;518;78;50;59;109
6;462;76;50;64;114
6;189;76;50;59;109
6;42;76;50;68;118
6;735;73;50;63;113
6;574;71;50;39;89
6;301;71;50;53;103
6;819;70;50;39;89
6;547;69;50;67;117
6;511;65;50;52;102
6;819;64;50;68;118
6;655;64;50;44;94
6;287;64;50;47;97
6;693;63;50;81;131
6;140;63;50;65;115
6;784;61;50;45;95
6;287;61;50;49;99
6;21;60;50;65;115
6;798;56;50;68;118
6;742;56;50;54;104
6;168;56;50;48;98
6;553;55;50;36;86
6;406;55;50;49;99
6;798;51;50;52;102
6;277;49;50;59;109
6;448;42;50;66;116
6;742;41;50;43;93
6;511;40;50;72;122
6;406;40;50;69;119
6;721;37;50;67;117
6;448;28;50;72;122
6;448;27;50;72;122
6;847;26;50;62;112
6;616;7;50;53;103
6;553;2;50;53;103
6;539;92;49;98;147
6;760;89;49;167;216
6;420;86;49;57;106
6;833;85;49;101;150
6;868;79;49;57;106
6;602;79;49;72;121
6;84;79;49;55;104
6;518;77;49;72;121
6;476;76;49;68;117
6;315;76;49;48;97
6;175;76;49;72;121
6;385;75;49;66;115
6;476;74;49;72;121
6;462;71;49;73;122
6;399;71;49;51;100
6;574;70;49;63;112
6;505;70;49;47;96
6;329;70;49;55;104
6;140;68;49;52;101
6;351;67;49;36;85
6;154;67;49;47;96
6;322;66;49;50;99
6;847;65;49;49;98
6;679;64;49;67;116
6;406;62;49;64;113
6;742;61;49;35;84
6;511;58;49;61;110
6;448;57;49;57;106
6;448;56;49;39;88
6;511;55;49;53;102
6;798;54;49;70;119
6;406;54;49;41;90
6;287;54;49;50;99
6;798;53;49;52;101
6;511;53;49;51;100
6;784;52;49;61;110
6;721;51;49;39;88
6;511;45;49;61;110
6;168;42;49;48;97
6;784;41;49;55;104
6;511;36;49;53;102
6;798;32;49;70;119
6;168;26;49;61;110
6;721;23;49;55;104
6;553;22;49;37;86
6;553;21;49;37;86
6;406;21;49;52;101
6;553;18;49;49;98
6;721;8;49;69;118
6;742;3;49;59;108
6;441;95;48;169;217
6;658;94;48;119;167
6;560;88;48;243;291
6;854;84;48;99;147
6;49;84;48;152;200
6;700;81;48;61;109
6;665;81;48;81;129
6;147;80;48;65;113
6;7;79;48;52;100
6;147;78;48;74;122
6;648;76;48;83;131
6;385;76;48;55;103
6;245;76;48;115;163
6;245;75;48;164;212
6;735;74;48;76;124
6;315;74;48;75;123
6;231;74;48;51;99
6;119;72;48;59;107
6;574;69;48;65;113
6;511;69;48;50;98
6;21;69;48;47;95
6;161;68;48;34;82
6;505;67;48;42;90
6;343;67;48;40;88
6;329;67;48;50;98
6;847;64;48;50;98
6;553;63;48;42;90
6;798;61;48;48;96
6;322;60;48;59;107
6;798;59;48;40;88
6;448;59;48;50;98
6;154;59;48;75;123
6;798;58;48;38;86
6;448;58;48;52;100
6;798;57;48;35;83
6;655;56;48;44;92
6;406;56;48;60;108
6;351;56;48;59;107
6;616;52;48;32;80
6;168;52;48;45;93
6;798;47;48;43;91
6;21;46;48;65;113
6;847;45;48;63;111
6;655;45;48;55;103
6;511;43;48;61;109
6;847;40;48;59;107
6;168;39;48;60;108
6;742;37;48;74;122
6;847;36;48;44;92
6;168;34;48;48;96
6;553;32;48;61;109
6;553;30;48;52;100
6;742;27;48;55;103
6;721;27;48;62;110
6;448;22;48;55;103
6;168;21;48;52;100
6;616;3;48;35;83
6;168;0;48;52;100
6;260;91;47;103;150
6;882;88;47;115;162
6;763;86;47;189;236
6;532;86;47;95;142
6;770;85;47;81;128
6;707;85;47;66;113
6;217;83;47;79;126
6;455;81;47;82;129
6;518;80;47;57;104
6;505;78;47;57;104
6;525;77;47;75;122
6;700;75;47;83;130
6;462;75;47;65;112
6;547;74;47;63;110
6;399;74;47;37;84
6;679;73;47;40;87
6;266;73;47;65;112
6;21;73;47;45;92
6;547;72;47;73;120
6;819;71;47;49;96
6;547;71;47;62;109
6;693;70;47;65;112
6;154;70;47;61;108
6;322;69;47;41;88
6;819;68;47;51;98
6;655;68;47;43;90
6;693;67;47;40;87
6;511;67;47;44;91
6;399;66;47;58;105
6;21;66;47;41;88
6;655;65;47;49;96
6;351;62;47;51;98
6;322;62;47;54;101
6;287;57;47;47;94
6;847;56;47;38;85
6;287;53;47;43;90
6;277;53;47;42;89
6;742;52;47;53;100
6;742;51;47;54;101
6;287;51;47;34;81
6;742;50;47;41;88
6;616;47;47;39;86
6;784;44;47;54;101
6;168;44;47;40;87
6;798;41;47;53;100
6;721;39;47;51;98
6;616;39;47;39;86
6;553;39;47;41;88
6;277;35;47;73;120
6;742;32;47;50;97
6;798;31;47;64;111
6;277;30;47;67;114
6;742;26;47;57;104
6;511;26;47;83;130
6;448;26;47;60;107
6;448;23;47;57;104
6;721;21;47;57;104
6;553;20;47;56;103
6;553;15;47;32;79
6;616;2;47;46;93
6;749;90;46;144;190
6;270;90;46;23;69
6;252;90;46;29;75
6;791;88;46;191;237
6;749;88;46;241;287
6;469;87;46;97;143
6;224;84;46;180;226
6;196;82;46;71;117
6;217;81;46;102;148
6;134;81;46;66;112
6;518;79;46;61;107
6;476;79;46;53;99
6;301;78;46;45;91
6;119;78;46;64;110
6;42;78;46;59;105
6;392;77;46;75;121
6;728;76;46;57;103
6;679;75;46;35;81
6;644;75;46;63;109
6;14;72;46;38;84
6;343;69;46;52;98
6;140;69;46;56;102
6;399;67;46;46;92
6;448;64;46;57;103
6;277;62;46;42;88
6;655;59;46;40;86
6;343;57;46;45;91
6;511;56;46;64;110
6;21;52;46;63;109
6;798;48;46;50;96
6;721;47;46;50;96
6;406;38;46;60;106
6;553;36;46;44;90
6;168;29;46;52;98
6;784;26;46;56;102
6;21;26;46;58;104
6;847;24;46;38;84
6;553;23;46;41;87
6;805;89;45;118;163
6;126;89;45;73;118
6;210;85;45;124;169
6;182;84;45;97;142
6;483;83;45;87;132
6;651;82;45;53;98
6;42;80;45;59;104
6;77;78;45;99;144
6;735;77;45;64;109
6;238;77;45;95;140
6;266;76;45;57;102
6;406;74;45;38;83
6;655;70;45;40;85
6;351;70;45;52;97
6;819;69;45;60;105
6;343;68;45;44;89
6;322;67;45;47;92
6;511;66;45;55;100
6;21;65;45;63;108
6;784;59;45;43;88
6;742;58;45;53;98
6;277;54;45;44;89
6;406;53;45;44;89
6;406;50;45;64;109
6;784;49;45;64;109
6;511;48;45;63;108
6;553;44;45;39;84
6;847;42;45;43;88
6;511;41;45;63;108
6;798;40;45;63;108
6;168;36;45;58;103
6;742;30;45;58;103
6;168;27;45;58;103
6;490;93;44;129;173
6;568;92;44;160;204
6;588;86;44;87;131
6;63;86;44;79;123
6;714;81;44;103;147
6;735;79;44;73;117
6;728;79;44;68;112
6;819;77;44;38;82
6;505;76;44;43;87
6;301;76;44;48;92
6;547;75;44;53;97
6;315;75;44;56;100
6;301;75;44;67;111
6;728;72;44;68;112
6;231;70;44;76;120
6;448;67;44;40;84
6;161;67;44;70;114
6;329;66;44;47;91
6;798;63;44;48;92
6;406;63;44;44;88
6;679;62;44;76;120
6;742;59;44;46;90
6;721;57;44;42;86
6;847;54;44;33;77
6;742;53;44;37;81
6;721;52;44;52;96
6;553;49;44;24;68
6;784;38;44;61;105
6;616;38;44;52;96
6;553;37;44;26;70
6;616;32;44;37;81
6;336;5;44;37;81
6;357;95;43;188;231
6;408;91;43;35;78
6;413;89;43;70;113
6;805;88;43;307;350
6;49;88;43;102;145
6;770;84;43;98;141
6;714;84;43;69;112
6;707;84;43;71;114
6;602;82;43;64;107
6;455;82;43;80;123
6;518;81;43;40;83
6;84;80;43;62;105
6;476;78;43;57;100
6;385;78;43;72;115
6;119;77;43;49;92
6;547;76;43;46;89
6;693;74;43;46;89
6;231;73;43;55;98
6;505;72;43;51;94
6;672;71;43;51;94
6;14;71;43;47;90
6;505;69;43;59;102
6;14;69;43;44;87
6;14;67;43;50;93
6;14;66;43;57;100
6;511;64;43;58;101
6;154;63;43;53;96
6;784;62;43;51;94
6;448;60;43;50;93
6;616;59;43;25;68
6;277;58;43;50;93
6;798;55;43;52;95
6;448;52;43;54;97
6;655;49;43;54;97
6;742;48;43;48;91
6;784;47;43;54;97
6;742;47;43;47;90
6;168;47;43;47;90
6;406;46;43;49;92
6;406;41;43;60;103
6;616;40;43;37;80
6;616;12;43;55;98
6;336;10;43;31;74
6;616;6;43;50;93
6;553;5;43;34;77
6;616;4;43;39;82
6;357;96;42;111;153
6;515;89;42;112;154
6;882;87;42;90;132
6;854;87;42;55;97
6;749;87;42;141;183
6;638;87;42;128;170
6;260;87;42;226;268
6;63;85;42;83;125
6;77;83;42;54;96
6;686;82;42;76;118
6;651;81;42;57;99
6;602;81;42;59;101
6;270;81;42;74;116
6;385;80;42;58;100
6;525;79;42;78;120
6;868;78;42;66;108
6;693;75;42;52;94
6;644;74;42;60;102
6;161;74;42;40;82
6;406;72;42;32;74
6;399;72;42;50;92
6;315;72;42;63;105
6;21;72;42;45;87
6;14;70;42;49;91
6;21;68;42;46;88
6;742;66;42;32;74
6;655;66;42;50;92
6;721;64;42;35;77
6;406;64;42;44;86
6;784;63;42;46;88
6;742;62;42;42;84
6;287;62;42;45;87
6;784;60;42;46;88
6;406;60;42;52;94
6;784;58;42;55;97
6;721;58;42;53;95
6;168;58;42;37;79
6;277;56;42;37;79
6;847;55;42;41;83
6;168;54;42;48;90
6;511;52;42;56;98
6;406;52;42;64;106
6;168;49;42;53;95
6;847;48;42;53;95
6;343;46;42;48;90
6;553;45;42;34;76
6;343;42;42;58;100
6;553;27;42;50;92
6;798;24;42;63;105
6;847;23;42;40;82
6;168;23;42;55;97
6;553;16;42;50;92
6;616;8;42;41;83
6;616;1;42;28;70
6;252;91;41;75;116
6;581;86;41;155;196
6;280;85;41;56;97
6;301;81;41;59;100
6;189;81;41;45;86
6;147;79;41;72;113
6;547;78;41;55;96
6;476;77;41;58;99
6;231;77;41;39;80
6;84;77;41;72;113
6;672;75;41;65;106
6;547;73;41;46;87
6;315;73;41;67;108
6;655;71;41;37;78
6;505;71;41;40;81
6;287;71;41;42;83
6;287;69;41;43;84
6;693;68;41;41;82
6;140;67;41;61;102
6;721;65;41;40;81
6;742;64;41;42;83
6;655;63;41;49;90
6;168;63;41;39;80
6;847;61;41;35;76
6;406;61;41;45;86
6;140;61;41;79;120
6;277;59;41;38;79
6;406;58;41;45;86
6;168;53;41;33;74
6;616;50;41;33;74
6;616;49;41;27;68
6;277;45;41;56;97
6;721;44;41;41;82
6;721;41;41;43;84
6;277;33;41;50;91
6;616;28;41;45;86
6;336;9;41;35;76
6;840;96;40;46;86
6;568;94;40;113;153
6;35;93;40;120;160
6;28;93;40;86;126
6;756;92;40;202;242
6;410;92;40;33;73
6;763;90;40;99;139
6;854;86;40;72;112
6;609;85;40;83;123
6;483;84;40;73;113
6;707;83;40;82;122
6;875;81;40;59;99
6;525;81;40;66;106
6;462;80;40;48;88
6;392;79;40;76;116
6;301;79;40;57;97
6;315;78;40;56;96
6;7;78;40;74;114
6;301;77;40;63;103
6;154;77;40;35;75
6;154;75;40;35;75
6;847;73;40;30;70
6;161;73;40;59;99
6;154;72;40;44;84
6;693;71;40;58;98
6;351;71;40;51;91
6;140;71;40;50;90
6;161;70;40;58;98
6;511;68;40;47;87
6;448;68;40;49;89
6;287;68;40;31;71
6;784;66;40;44;84
6;287;66;40;42;82
6;742;63;40;50;90
6;553;61;40;39;79
6;847;53;40;45;85
6;847;44;40;55;95
6;511;44;40;64;104
6;847;43;40;45;85
6;553;43;40;30;70
6;168;43;40;55;95
6;847;41;40;32;72
6;616;35;40;31;71
6;616;31;40;37;77
6;616;23;40;24;64
6;798;22;40;57;97
6;616;21;40;37;77
6;616;19;40;39;79
6;756;91;39;179;218
6;371;91;39;174;213
6;420;87;39;51;90
6;210;86;39;108;147
6;826;85;39;66;105
6;763;85;39;200;239
6;714;85;39;69;108
6;203;84;39;74;113
6;875;83;39;46;85
6;609;83;39;74;113
6;217;82;39;90;129
6;196;81;39;71;110
6;84;81;39;62;101
6;728;80;39;59;98
6;196;80;39;73;112
6;644;77;39;41;80
6;154;76;39;33;72
6;819;75;39;47;86
6;343;75;39;41;80
6;679;74;39;55;94
6;154;74;39;50;89
6;14;74;39;45;84
6;693;72;39;33;72
6;322;70;39;29;68
6;742;68;39;31;70
6;742;65;39;44;83
6;277;64;39;39;78
6;277;63;39;34;73
6;847;62;39;67;106
6;277;61;39;40;79
6;553;60;39;40;79
6;847;58;39;48;87
6;168;38;39;52;91
6;616;24;39;47;86
6;630;21;39;27;66
6;616;20;39;52;91
6;630;9;39;34;73
6;616;9;39;43;82
6;616;0;39;52;91
6;434;91;38;271;309
6;91;88;38;175;213
6;252;85;38;117;155
6;826;84;38;66;104
6;455;84;38;60;98
6;651;83;38;53;91
6;70;83;38;66;104
6;700;82;38;60;98
6;77;82;38;64;102
6;294;81;38;46;84
6;700;80;38;68;106
6;651;80;38;73;111
6;294;80;38;51;89
6;14;79;38;51;89
6;315;77;38;59;97
6;644;76;38;51;89
6;648;75;38;78;116
6;574;75;38;55;93
6;119;75;38;65;103
6;574;73;38;48;86
6;351;73;38;34;72
6;154;73;38;55;93
6;231;72;38;65;103
6;406;71;38;37;75
6;784;70;38;42;80
6;343;70;38;31;69
6;21;70;38;53;91
6;351;69;38;36;74
6;798;68;38;37;75
6;784;65;38;42;80
6;553;64;38;34;72
6;721;63;38;41;79
6;168;61;38;47;85
6;655;52;38;58;96
6;616;48;38;48;86
6;742;40;38;58;96
6;616;37;38;34;72
6;553;33;38;49;87
6;630;20;38;39;77
6;630;13;38;24;62
6;630;12;38;24;62
6;616;5;38;57;95
6;721;3;38;62;100
6;434;93;37;179;216
6;410;90;37;185;222
6;98;88;37;82;119
6;134;85;37;56;93
6;70;84;37;65;102
6;602;83;37;57;94
6;665;82;37;64;101
6;868;81;37;42;79
6;385;81;37;47;84
6;147;81;37;68;105
6;175;80;37;65;102
6;672;79;37;46;83
6;266;79;37;50;87
6;735;78;37;61;98
6;728;78;37;65;102
6;84;78;37;67;104
6;21;78;37;40;77
6;574;77;37;50;87
6;505;77;37;51;88
6;655;75;37;39;76
6;21;74;37;58;95
6;655;73;37;44;81
6;574;72;37;54;91
6;140;72;37;57;94
6;343;71;37;37;74
6;168;70;37;34;71
6;847;69;37;32;69
6;784;68;37;42;79
6;14;68;37;56;93
6;343;66;37;49;86
6;798;65;37;46;83
6;616;62;37;27;64
6;847;59;37;48;85
6;553;57;37;36;73
6;168;57;37;30;67
6;277;52;37;49;86
6;553;47;37;35;72
6;553;40;37;32;69
6;616;34;37;37;74
6;616;27;37;36;73
6;553;25;37;38;75
6;616;18;37;44;81
6;336;13;37;31;68
6;336;1;37;31;68
6;35;94;36;66;102
6;623;90;36;90;126
6;623;89;36;214;250
6;826;86;36;55;91
6;112;86;36;92;128
6;105;85;36;76;112
6;686;84;36;37;73
6;651;84;36;47;83
6;217;84;36;97;133
6;700;83;36;50;86
6;525;83;36;54;90
6;196;83;36;52;88
6;147;83;36;48;84
6;778;82;36;62;98
6;392;82;36;56;92
6;147;82;36;69;105
6;70;82;36;78;114
6;778;81;36;77;113
6;266;80;36;60;96
6;315;79;36;61;97
6;294;79;36;71;107
6;648;78;36;106;142
6;728;77;36;55;91
6;266;77;36;40;76
6;231;76;36;41;77
6;14;76;36;40;76
6;672;74;36;48;84
6;140;73;36;49;85
6;161;71;36;49;85
6;406;70;36;39;75
6;798;69;36;16;52
6;693;69;36;52;88
6;329;68;36;42;78
6;742;67;36;45;81
6;277;66;36;26;62
6;168;64;36;35;71
6;721;62;36;51;87
6;742;57;36;53;89
6;721;55;36;46;82
6;553;54;36;35;71
6;616;44;36;40;76
6;553;24;36;38;74
6;336;16;36;41;77
6;336;8;36;44;80
6;588;88;35;58;93
6;280;88;35;41;76
6;588;87;35;83;118
6;105;87;35;77;112
6;217;86;35;73;108
6;686;83;35;64;99
6;868;82;35;46;81
6;266;82;35;44;79
6;462;81;35;59;94
6;266;81;35;40;75
6;385;79;35;78;113
6;119;79;35;75;110
6;21;79;35;38;73
6;189;77;35;62;97
6;161;77;35;44;79
6;119;76;35;60;95
6;21;76;35;33;68
6;505;75;35;35;70
6;476;75;35;66;101
6;14;75;35;42;77
6;343;74;35;29;64
6;287;74;35;28;63
6;343;73;35;41;76
6;14;73;35;47;82
6;742;71;35;33;68
6;322;71;35;42;77
6;168;69;35;31;66
6;847;67;35;37;72
6;168;67;35;35;70
6;21;67;35;48;83
6;721;66;35;38;73
6;553;65;35;40;75
6;847;63;35;41;76
6;168;62;35;39;74
6;798;60;35;48;83
6;336;60;35;12;47
6;553;58;35;36;71
6;721;54;35;52;87
6;847;52;35;45;80
6;168;50;35;51;86
6;616;45;35;30;65
6;847;29;35;52;87
6;308;29;35;18;53
6;630;15;35;34;69
6;336;14;35;28;63
6;630;10;35;25;60
6;630;0;35;31;66
6;357;97;34;70;104
6;861;95;34;96;130
6;581;93;34;40;74
6;560;90;34;117;151
6;412;89;34;81;115
6;245;87;34;35;69
6;469;86;34;68;102
6;252;86;34;134;168
6;280;84;34;71;105
6;175;84;34;56;90
6;14;83;34;42;76
6;735;81;34;64;98
6;238;81;34;87;121
6;175;81;34;72;106
6;735;80;34;63;97
6;602;80;34;67;101
6;315;80;34;51;85
6;7;80;34;58;92
6;462;78;34;72;106
6;399;77;34;40;74
6;294;77;34;64;98
6;161;76;34;44;78
6;231;75;34;35;69
6;819;74;34;38;72
6;693;73;34;38;72
6;511;70;34;36;70
6;721;69;34;37;71
6;655;69;34;40;74
6;721;68;34;33;67
6;168;68;34;32;66
6;798;67;34;32;66
6;721;67;34;50;84
6;655;67;34;55;89
6;448;61;34;48;82
6;168;60;34;44;78
6;553;59;34;37;71
6;616;58;34;29;63
6;553;48;34;44;78
6;847;46;34;46;80
6;616;33;34;42;76
6;616;26;34;32;66
6;336;20;34;28;62
6;630;18;34;45;79
6;630;6;34;24;58
6;336;3;34;29;63
6;623;92;33;34;67
6;763;91;33;71;104
6;638;91;33;31;64
6;420;88;33;56;89
6;252;88;33;76;109
6;105;88;33;65;98
6;665;84;33;54;87
6;245;83;33;112;145
6;238;83;33;61;94
6;175;83;33;52;85
6;728;82;33;59;92
6;301;82;33;49;82
6;728;81;33;66;99
6;574;80;33;45;78
6;672;77;33;43;76
6;655;76;33;35;68
6;399;76;33;48;81
6;140;75;33;42;75
6;574;74;33;47;80
6;351;74;33;40;73
6;322;74;33;32;65
6;399;73;33;40;73
6;679;72;33;56;89
6;655;72;33;40;73
6;329;72;33;51;84
6;329;69;33;52;85
6;322;68;33;48;81
6;287;67;33;46;79
6;168;65;33;33;66
6;616;64;33;32;65
6;448;63;33;47;80
6;655;61;33;49;82
6;616;61;33;35;68
6;553;56;33;30;63
6;168;55;33;40;73
6;616;53;33;29;62
6;616;51;33;32;65
6;553;50;33;34;67
6;616;43;33;33;66
6;616;42;33;25;58
6;553;42;33;37;70
6;553;41;33;36;69
6;630;26;33;33;66
6;336;4;33;41;74
6;658;95;32;116;148
6;515;92;32;75;107
6;539;91;32;71;103
6;245;91;32;14;46
6;595;89;32;142;174
6;609;87;32;55;87
6;252;87;32;122;154
6;63;87;32;59;91
6;714;86;32;55;87
6;609;86;32;74;106
6;483;85;32;56;88
6;455;85;32;56;88
6;728;84;32;43;75
6;270;84;32;104;136
6;714;83;32;62;94
6;665;83;32;59;91
6;385;83;32;57;89
6;270;83;32;144;176
6;182;83;32;80;112
6;462;82;32;41;73
6;189;82;32;59;91
6;175;82;32;66;98
6;644;81;32;37;69
6;476;81;32;49;81
6;238;80;32;89;121
6;693;79;32;37;69
6;644;79;32;31;63
6;399;78;32;39;71
6;266;78;32;54;86
6;679;77;32;39;71
6;140;77;32;38;70
6;672;76;32;51;83
6;399;75;32;40;72
6;287;75;32;27;59
6;161;75;32;26;58
6;655;74;32;40;72
6;406;73;32;36;68
6;742;72;32;40;72
6;798;70;32;30;62
6;277;70;32;37;69
6;784;67;32;48;80
6;277;67;32;25;57
6;277;65;32;39;71
6;798;64;32;36;68
6;630;31;32;22;54
6;616;29;32;37;69
6;336;17;32;41;73
6;336;12;32;37;69
6;630;7;32;23;55
6;630;1;32;40;72
6;560;94;31;47;78
6;749;92;31;74;105
6;260;92;31;60;91
6;560;89;31;73;104
6;260;89;31;90;121
6;245;89;31;34;65
6;112;87;31;65;96
6;770;86;31;85;116
6;707;86;31;48;79
6;364;86;31;26;57
6;294;85;31;26;57
6;700;84;31;42;73
6;728;83;31;35;66
6;532;83;31;164;195
6;392;83;31;50;81
6;505;82;31;37;68
6;294;82;31;53;84
6;42;82;31;62;93
6;189;80;31;65;96
6;505;79;31;44;75
6;574;78;31;44;75
6;189;78;31;67;98
6;14;77;31;43;74
6;574;76;31;39;70
6;161;72;31;41;72
6;448;71;31;38;69
6;329;71;31;42;73
6;721;70;31;39;70
6;448;69;31;42;73
6;406;67;31;57;88
6;847;66;31;42;73
6;784;64;31;43;74
6;308;56;31;11;42
6;553;52;31;45;76
6;616;46;31;36;67
6;336;35;31;23;54
6;336;33;31;30;61
6;336;31;31;26;57
6;630;24;31;22;53
6;308;18;31;18;49
6;308;14;31;33;64
6;336;6;31;33;64
6;630;2;31;24;55
6;861;96;30;52;82
6;539;95;30;35;65
6;98;94;30;26;56
6;412;90;30;39;69
6;210;88;30;62;92
6;770;87;30;74;104
6;280;87;30;44;74
6;602;85;30;51;81
6;70;85;30;59;89
6;77;84;30;52;82
6;385;82;30;53;83
6;119;81;30;33;63
6;14;80;30;33;63
6;231;79;30;39;69
6;819;78;30;34;64
6;679;78;30;24;54
6;644;78;30;51;81
6;448;78;30;25;55
6;679;76;30;55;85
6;511;75;30;37;67
6;329;75;30;45;75
6;21;75;30;52;82
6;742;74;30;33;63
6;140;74;30;55;85
6;819;73;30;45;75
6;448;73;30;29;59
6;154;71;30;47;77
6;553;70;30;27;57
6;448;70;30;40;70
6;784;69;30;38;68
6;553;66;30;34;64
6;616;63;30;34;64
6;616;54;30;30;60
6;336;30;30;33;63
6;308;12;30;20;50
6;630;11;30;33;63
6;308;9;30;22;52
6;336;7;30;39;69
6;224;92;29;18;47
6;112;88;29;65;94
6;364;87;29;50;79
6;182;87;29;59;88
6;42;86;29;48;77
6;217;85;29;67;96
6;525;84;29;45;74
6;476;84;29;31;60
6;119;83;29;54;83
6;7;83;29;34;63
6;315;81;29;47;76
6;140;81;29;31;60
6;301;80;29;49;78
6;547;79;29;61;90
6;42;79;29;63;92
6;511;78;29;30;59
6;154;78;29;38;67
6;343;76;29;48;77
6;505;74;29;42;71
6;329;74;29;30;59
6;798;73;29;27;56
6;784;73;29;30;59
6;742;70;29;39;68
6;406;69;29;45;74
6;553;68;29;22;51
6;798;66;29;40;69
6;553;62;29;30;59
6;616;55;29;39;68
6;336;55;29;22;51
6;630;49;29;24;53
6;336;25;29;29;58
6;308;25;29;17;46
6;336;19;29;21;50
6;630;14;29;31;60
6;630;8;29;32;61
6;490;94;28;117;145
6;638;90;28;75;103
6;280;86;28;65;93
6;105;86;28;80;108
6;648;85;28;49;77
6;392;84;28;56;84
6;672;83;28;40;68
6;476;83;28;52;80
6;525;82;28;52;80
6;119;82;28;47;75
6;679;81;28;20;48
6;231;81;28;38;66
6;231;80;28;35;63
6;679;79;28;29;57
6;648;79;28;67;95
6;693;78;28;44;72
6;322;77;28;24;52
6;819;76;28;49;77
6;406;76;28;32;60
6;140;76;28;41;69
6;448;72;28;33;61
6;721;71;28;40;68
6;847;70;28;48;76
6;287;70;28;43;71
6;277;69;28;33;61
6;336;62;28;11;39
6;553;46;28;28;56
6;630;39;28;20;48
6;630;37;28;20;48
6;630;30;28;24;52
6;630;25;28;30;58
6;336;23;28;29;57
6;336;2;28;29;57
6;756;93;27;181;208
6;28;91;27;122;149
6;854;88;27;60;87
6;210;87;27;82;109
6;651;86;27;53;80
6;196;86;27;34;61
6;700;85;27;33;60
6;392;85;27;48;75
6;196;85;27;61;88
6;175;85;27;46;73
6;147;85;27;47;74
6;245;82;27;141;168
6;238;82;27;63;90
6;648;81;27;118;145
6;672;80;27;35;62
6;547;80;27;57;84
6;119;80;27;54;81
6;574;79;27;40;67
6;399;79;27;40;67
6;798;78;27;22;49
6;14;78;27;44;71
6;547;77;27;45;72
6;329;77;27;32;59
6;21;77;27;45;72
6;693;76;27;37;64
6;847;75;27;35;62
6;721;73;27;27;54
6;329;73;27;49;76
6;847;72;27;26;53
6;553;69;27;27;54
6;277;68;27;32;59
6;616;67;27;33;60
6;168;66;27;29;56
6;616;60;27;27;54
6;553;53;27;42;69
6;336;49;27;19;46
6;336;42;27;22;49
6;336;29;27;29;56
6;630;28;27;25;52
6;336;28;27;26;53
6;336;27;27;26;53
6;616;25;27;26;53
6;616;22;27;37;64
6;336;21;27;20;47
6;308;5;27;15;42
6;630;3;27;27;54
6;357;94;26;181;207
6;364;88;26;22;48
6;595;87;26;137;163
6;455;86;26;56;82
6;651;85;26;45;71
6;385;84;26;39;65
6;518;83;26;29;55
6;455;83;26;68;94
6;343;83;26;19;45
6;315;83;26;43;69
6;134;83;26;44;70
6;42;83;26;50;76
6;819;81;26;35;61
6;693;81;26;37;63
6;672;81;26;47;73
6;574;81;26;36;62
6;154;81;26;23;49
6;868;80;26;57;83
6;847;80;26;28;54
6;655;80;26;21;47
6;644;80;26;33;59
6;406;79;26;29;55
6;343;79;26;33;59
6;161;78;26;27;53
6;784;77;26;27;53
6;721;76;26;32;58
6;742;75;26;36;62
6;511;73;26;34;60
6;511;72;26;31;57
6;287;72;26;32;58
6;168;72;26;24;50
6;616;70;26;28;54
6;847;57;26;34;60
6;616;57;26;34;60
6;553;51;26;38;64
6;616;41;26;44;70
6;336;41;26;20;46
6;630;36;26;20;46
6;630;27;26;30;56
6;336;24;26;24;50
6;336;11;26;33;59
6;56;94;25;148;173
6;126;93;25;36;61
6;98;90;25;58;83
6;238;87;25;42;67
6;217;87;25;62;87
6;483;86;25;65;90
6;175;86;25;44;69
6;686;85;25;51;76
6;679;85;25;13;38
6;245;85;25;111;136
6;868;84;25;45;70
6;602;84;25;60;85
6;189;84;25;47;72
6;462;83;25;34;59
6;189;83;25;47;72
6;476;82;25;52;77
6;84;82;25;54;79
6;7;82;25;47;72
6;7;81;25;49;74
6;154;80;25;29;54
6;819;79;25;42;67
6;329;78;25;35;60
6;245;78;25;160;185
6;231;78;25;48;73
6;277;77;25;19;44
6;847;76;25;23;48
6;351;76;25;26;51
6;448;75;25;28;53
6;277;75;25;28;53
6;847;74;25;39;64
6;784;74;25;38;63
6;511;74;25;41;66
6;721;72;25;33;58
6;616;72;25;19;44
6;351;72;25;35;60
6;322;72;25;28;53
6;798;71;25;24;49
6;784;71;25;32;57
6;616;68;25;29;54
6;553;67;25;33;58
6;336;56;25;17;42
6;336;44;25;20;45
6;616;36;25;36;61
6;630;35;25;21;46
6;308;28;25;15;40
6;553;26;25;36;61
6;630;23;25;26;51
6;630;22;25;23;48
6;630;17;25;40;65
6;336;15;25;33;58
6;812;11;25;22;47
6;630;5;25;37;62
6;630;4;25;23;48
6;56;96;24;32;56
6;568;95;24;62;86
6;791;93;24;56;80
6;224;90;24;58;82
6;588;89;24;63;87
6;210;89;24;54;78
6;245;88;24;58;82
6;126;88;24;56;80
6;63;88;24;53;77
6;455;87;24;52;76
6;203;87;24;52;76
6;602;86;24;41;65
6;147;86;24;42;66
6;735;85;24;51;75
6;189;85;24;32;56
6;77;85;24;58;82
6;518;84;24;33;57
6;134;84;24;51;75
6;7;84;24;39;63
6;778;83;24;77;101
6;42;81;24;43;67
6;721;80;24;15;39
6;505;80;24;35;59
6;351;79;24;28;52
6;672;78;24;43;67
6;448;77;24;28;52
6;798;76;24;28;52
6;784;76;24;22;46
6;448;76;24;34;58
6;287;76;24;25;49
6;784;75;24;34;58
6;798;74;24;33;57
6;721;74;24;33;57
6;448;74;24;45;69
6;168;74;24;27;51
6;742;73;24;40;64
6;287;73;24;40;64
6;798;72;24;28;52
6;742;69;24;25;49
6;630;55;24;17;41
6;336;48;24;23;47
6;336;34;24;34;58
6;336;26;24;15;39
6;336;18;24;24;48
6;308;6;24;22;46
6;595;92;23;49;72
6;882;91;23;77;100
6;805;91;23;79;102
6;588;91;23;37;60
6;833;90;23;57;80
6;105;90;23;58;81
6;182;89;23;53;76
6;182;88;23;68;91
6;602;87;23;32;55
6;483;87;23;50;73
6;126;87;23;86;109
6;778;86;23;57;80
6;203;86;23;57;80
6;875;85;23;41;64
6;525;85;23;35;58
6;476;85;23;42;65
6;875;84;23;38;61
6;819;84;23;40;63
6;778;84;23;55;78
6;238;84;23;60;83
6;84;84;23;48;71
6;868;83;23;34;57
6;819;83;23;35;58
6;735;83;23;43;66
6;547;83;23;31;54
6;154;83;23;28;51
6;511;82;23;29;52
6;505;81;23;37;60
6;721;79;23;33;56
6;511;79;23;35;58
6;655;78;23;25;48
6;140;78;23;40;63
6;798;77;23;25;48
6;277;76;23;22;45
6;351;75;23;41;64
6;277;74;23;20;43
6;784;72;23;35;58
6;616;69;23;20;43
6;336;66;23;8;31
6;336;61;23;17;40
6;630;54;23;16;39
6;630;52;23;14;37
6;630;48;23;17;40
6;336;46;23;18;41
6;630;42;23;19;42
6;630;41;23;32;55
6;336;40;23;20;43
6;336;32;23;28;51
6;308;24;23;20;43
6;308;22;23;15;38
6;308;20;23;27;50
6;308;19;23;16;39
6;630;16;23;30;53
6;308;16;23;24;47
6;812;7;23;15;38
6;308;3;23;26;49
6;336;0;23;22;45
6;658;97;22;16;38
6;410;97;22;23;45
6;28;96;22;28;50
6;413;95;22;34;56
6;28;95;22;59;81
6;861;94;22;95;117
6;756;94;22;106;128
6;805;93;22;47;69
6;410;93;22;88;110
6;840;92;22;209;231
6;413;91;22;43;65
6;410;91;22;61;83
6;595;90;22;129;151
6;515;90;22;82;104
6;413;90;22;86;108
6;126;90;22;23;45
6;274;89;22;116;138
6;112;89;22;52;74
6;49;89;22;92;114
6;707;87;22;69;91
6;728;86;22;31;53
6;294;86;22;26;48
6;77;86;22;48;70
6;665;85;22;49;71
6;462;85;22;27;49
6;42;84;22;47;69
6;679;83;22;34;56
6;847;79;22;24;46
6;655;79;22;31;53
6;168;79;22;28;50
6;140;79;22;28;50
6;287;77;22;26;48
6;329;76;22;37;59
6;168;76;22;23;45
6;553;71;22;27;49
6;336;52;22;19;41
6;308;46;22;13;35
6;630;44;22;19;41
6;336;39;22;20;42
6;630;38;22;25;47
6;308;35;22;16;38
6;336;22;22;24;46
6;812;15;22;9;31
6;812;12;22;12;34
6;308;4;22;20;42
6;308;0;22;20;42
6;882;95;21;3;24
6;371;95;21;82;103
6;805;94;21;35;56
6;224;91;21;40;61
6;182;90;21;55;76
6;532;89;21;147;168
6;105;89;21;51;72
6;770;88;21;59;80
6;714;87;21;50;71
6;700;87;21;38;59
6;868;86;21;27;48
6;245;86;21;72;93
6;518;85;21;21;42
6;126;85;21;76;97
6;735;84;21;66;87
6;266;84;21;41;62
6;245;84;21;124;145
6;21;84;21;36;57
6;161;83;21;23;44
6;547;82;21;42;63
6;518;82;21;43;64
6;21;82;21;51;72
6;547;81;21;40;61
6;329;81;21;38;59
6;14;81;21;39;60
6;819;80;21;46;67
6;679;80;21;44;65
6;511;80;21;35;56
6;399;80;21;42;63
6;329;80;21;35;56
6;742;79;21;25;46
6;329;79;21;35;56
6;322;79;21;35;56
6;154;79;21;36;57
6;847;78;21;19;40
6;742;78;21;26;47
6;406;78;21;31;52
6;343;78;21;31;52
6;322;78;21;16;37
6;693;77;21;41;62
6;798;75;21;35;56
6;322;73;21;25;46
6;553;72;21;18;39
6;847;71;21;31;52
6;511;71;21;37;58
6;277;71;21;18;39
6;168;71;21;35;56
6;336;70;21;14;35
6;630;62;21;19;40
6;630;59;21;15;36
6;336;54;21;16;37
6;336;50;21;12;33
6;812;46;21;12;33
6;308;45;21;18;39
6;630;40;21;30;51
6;336;38;21;26;47
6;630;34;21;22;43
6;630;32;21;28;49
6;630;19;21;34;55
6;308;11;21;21;42
6;308;8;21;16;37
6;812;5;21;14;35
6;308;1;21;16;37
6;408;96;20;21;41
6;91;94;20;54;74
6;539;93;20;95;115
6;91;92;20;50;70
6;260;90;20;156;176
6;707;88;20;48;68
6;98;87;20;106;126
6;70;87;20;34;54
6;686;86;20;43;63
6;70;86;20;54;74
6;728;85;20;45;65
6;315;85;20;24;44
6;238;85;20;50;70
6;315;84;20;41;61
6;196;84;20;58;78
6;644;83;20;25;45
6;301;83;20;48;68
6;847;82;20;26;46
6;735;82;20;46;66
6;322;82;20;23;43
6;231;82;20;32;52
6;742;81;20;33;53
6;655;81;20;17;37
6;399;81;20;46;66
6;21;81;20;45;65
6;693;80;20;41;61
6;140;80;20;37;57
6;798;79;20;22;42
6;784;78;20;27;47
6;168;77;20;31;51
6;322;76;20;24;44
6;616;75;20;14;34
6;168;75;20;27;47
6;616;74;20;23;43
6;553;73;20;19;39
6;277;72;20;19;39
6;630;58;20;15;35
6;616;56;20;30;50
6;630;50;20;23;43
6;630;47;20;21;41
6;630;46;20;19;39
6;336;45;20;21;41
6;308;38;20;18;38
6;630;33;20;21;41
6;812;10;20;7;27
6;791;99;19;12;31
6;539;98;19;24;43
6;28;98;19;16;35
6;91;96;19;10;29
6;274;94;19;54;73
6;260;94;19;19;38
6;371;92;19;225;244
6;770;90;19;44;63
6;609;90;19;44;63
6;210;90;19;40;59
6;714;89;19;40;59
6;609;89;19;52;71
6;420;89;19;33;52
6;63;89;19;54;73
6;175;88;19;28;47
6;735;87;19;34;53
6;77;87;19;55;74
6;875;86;19;32;51
6;462;86;19;31;50
6;238;86;19;40;59
6;385;85;19;37;56
6;266;85;19;25;44
6;462;84;19;47;66
6;231;84;19;30;49
6;147;84;19;51;70
6;329;83;19;25;44
6;294;83;19;50;69
6;693;82;19;27;46
6;644;82;19;30;49
6;14;82;19;41;60
6;343;81;19;35;54
6;406;80;19;33;52
6;343;80;19;27;46
6;161;80;19;39;58
6;448;79;19;32;51
6;161;79;19;33;52
6;287;78;19;18;37
6;168;78;19;31;50
6;742;77;19;19;38
6;511;77;19;46;65
6;406;77;19;28;47
6;742;76;19;22;41
6;721;75;19;37;56
6;553;75;19;14;33
6;406;75;19;41;60
6;343;72;19;34;53
6;616;71;19;18;37
6;616;66;19;21;40
6;616;65;19;35;54
6;308;60;19;19;38
6;308;52;19;10;29
6;308;48;19;20;39
6;630;45;19;16;35
6;630;43;19;28;47
6;630;29;19;26;45
6;812;19;19;16;35
6;308;17;19;24;43
6;308;10;19;25;44
6;812;8;19;14;33
6;308;7;19;14;33
6;490;98;18;38;56
6;35;98;18;15;33
6;840;97;18;47;65
6;28;94;18;66;84
6;854;91;18;29;47
6;833;91;18;47;65
6;854;90;18;44;62
6;588;90;18;55;73
6;91;90;18;97;115
6;70;90;18;28;46
6;224;89;18;96;114
6;609;88;18;58;76
6;469;88;18;42;60
6;203;88;18;45;63
6;826;87;18;53;71
6;392;87;18;29;47
6;175;87;18;32;50
6;525;86;18;46;64
6;518;86;18;22;40
6;476;86;18;32;50
6;819;85;18;20;38
6;778;85;18;49;67
6;644;85;18;23;41
6;574;85;18;32;50
6;301;85;18;54;72
6;648;84;18;124;142
6;505;84;18;35;53
6;693;83;18;34;52
6;574;83;18;33;51
6;399;83;18;33;51
6;140;83;18;33;51
6;819;82;18;34;52
6;315;82;18;48;66
6;287;82;18;18;36
6;154;82;18;22;40
6;511;81;18;39;57
6;448;81;18;24;42
6;21;80;18;38;56
6;168;73;18;26;44
6;630;61;18;12;30
6;308;61;18;13;31
6;630;53;18;25;43
6;308;53;18;13;31
6;308;51;18;14;32
6;336;36;18;26;44
6;308;30;18;21;39
6;812;21;18;14;32
6;308;21;18;18;36
6;812;16;18;12;30
6;812;6;18;11;29
6;595;93;17;25;42
6;568;93;17;146;163
6;560;91;17;62;79
6;826;90;17;26;43
6;707;90;17;19;36
6;648;90;17;29;46
6;112;90;17;42;59
6;707;89;17;44;61
6;497;89;17;83;100
6;469;89;17;55;72
6;778;88;17;33;50
6;714;88;17;33;50
6;483;88;17;63;80
6;238;88;17;39;56
6;196;88;17;23;40
6;686;87;17;37;54
6;301;87;17;31;48
6;189;87;17;34;51
6;679;86;17;16;33
6;672;86;17;32;49
6;665;86;17;38;55
6;385;86;17;33;50
6;42;85;17;43;60
6;7;85;17;29;46
6;798;84;17;27;44
6;399;84;17;34;51
6;294;84;17;41;58
6;154;84;17;19;36
6;140;84;17;24;41
6;84;83;17;45;62
6;574;82;17;25;42
6;161;82;17;38;55
6;351;80;17;22;39
6;721;78;17;26;43
6;351;78;17;39;56
6;847;77;17;26;43
6;655;77;17;42;59
6;343;77;17;37;54
6;322;75;17;45;62
6;553;74;17;13;30
6;277;73;17;28;45
6;336;63;17;17;34
6;308;57;17;15;32
6;630;56;17;20;37
6;812;54;17;9;26
6;308;43;17;26;43
6;308;42;17;12;29
6;308;39;17;18;35
6;336;37;17;14;31
6;308;36;17;15;32
6;308;32;17;13;30
6;308;31;17;18;35
6;812;20;17;22;39
6;308;15;17;23;40
6;427;96;16;104;120
6;581;92;16;48;64
6;609;91;16;26;42
6;483;90;16;36;52
6;469;90;16;39;55
6;49;90;16;25;41
6;826;89;16;41;57
6;280;89;16;38;54
6;651;87;16;19;35
6;147;87;16;29;45
6;119;87;16;33;49
6;392;86;16;35;51
6;547;85;16;35;51
6;231;85;16;33;49
6;448;84;16;24;40
6;364;84;16;67;83
6;798;83;16;19;35
6;655;83;16;25;41
6;399;82;16;35;51
6;343;82;16;27;43
6;140;82;16;33;49
6;721;81;16;24;40
6;406;81;16;31;47
6;351;81;16;28;44
6;161;81;16;31;47
6;721;77;16;25;41
6;351;77;16;29;45
6;511;76;16;31;47
6;616;73;16;23;39
6;336;64;16;18;34
6;336;58;16;13;29
6;308;58;16;8;24
6;308;49;16;15;31
6;812;9;16;18;34
6;638;94;15;30;45
6;623;93;15;42;57
6;791;91;15;94;109
6;581;90;15;63;78
6;203;90;15;24;39
6;833;89;15;88;103
6;770;89;15;52;67
6;77;89;15;32;47
6;665;88;15;26;41
6;665;87;15;26;41
6;518;87;15;20;35
6;476;87;15;25;40
6;462;87;15;25;40
6;294;87;15;39;54
6;644;86;15;20;35
6;140;86;15;25;40
6;406;85;15;20;35
6;21;85;15;29;44
6;742;84;15;16;31
6;672;84;15;33;48
6;574;84;15;31;46
6;406;84;15;17;32
6;351;84;15;17;32
6;301;84;15;60;75
6;168;84;15;25;40
6;784;83;15;21;36
6;448;83;15;16;31
6;231;83;15;27;42
6;21;83;15;25;40
6;721;82;15;18;33
6;679;82;15;23;38
6;847;81;15;25;40
6;798;81;15;35;50
6;322;81;15;12;27
6;277;81;15;22;37
6;448;80;15;27;42
6;322;80;15;31;46
6;784;79;15;24;39
6;630;68;15;12;27
6;336;68;15;12;27
6;308;68;15;13;28
6;630;65;15;14;29
6;308;64;15;11;26
6;308;63;15;11;26
6;308;62;15;14;29
6;308;59;15;9;24
6;630;57;15;14;29
6;630;51;15;17;32
6;308;44;15;17;32
6;308;40;15;10;25
6;812;38;15;9;24
6;308;37;15;21;36
6;308;34;15;16;31
6;308;33;15;12;27
6;812;24;15;12;27
6;308;23;15;22;37
6;812;17;15;21;36
6;812;14;15;13;28
6;308;13;15;20;35
6;126;100;14;1;15
6;490;97;14;61;75
6;833;94;14;19;33
6;760;94;14;54;68
6;749;93;14;66;80
6;707;91;14;20;34
6;420;90;14;30;44
6;455;89;14;35;49
6;252;89;14;78;92
6;147;89;14;35;49
6;119;88;14;27;41
6;875;87;14;24;38
6;778;87;14;51;65
6;728;87;14;35;49
6;385;87;14;30;44
6;134;87;14;41;55
6;700;86;14;40;54
6;189;86;14;42;56
6;21;86;14;23;37
6;505;85;14;36;50
6;511;84;14;22;36
6;14;84;14;25;39
6;847;83;14;17;31
6;266;83;14;38;52
6;655;82;14;30;44
6;329;82;14;40;54
6;277;82;14;20;34
6;784;81;14;17;31
6;553;81;14;6;20
6;287;81;14;30;44
6;168;81;14;17;31
6;287;80;14;22;36
6;277;80;14;27;41
6;308;77;14;10;24
6;553;76;14;17;31
6;308;70;14;14;28
6;308;69;14;13;27
6;630;67;14;12;26
6;308;67;14;10;24
6;630;63;14;12;26
6;336;57;14;8;22
6;308;54;14;10;24
6;336;47;14;25;39
6;308;47;14;22;36
6;336;43;14;24;38
6;308;41;14;17;31
6;812;37;14;11;25
6;812;22;14;11;25
6;812;13;14;14;28
6;413;97;13;2;15
6;623;96;13;19;32
6;441;94;13;179;192
6;588;93;13;20;33
6;105;91;13;32;45
6;63;91;13;30;43
6;882;90;13;36;49
6;714;90;13;34;47
6;700;90;13;26;39
6;84;90;13;19;32
6;63;90;13;33;46
6;525;89;13;23;36
6;483;89;13;45;58
6;410;89;13;100;113
6;364;89;13;52;65
6;868;88;13;24;37
6;392;88;13;27;40
6;385;88;13;20;33
6;217;88;13;45;58
6;868;87;13;19;32
6;266;87;13;25;38
6;735;86;13;29;42
6;343;86;13;25;38
6;119;86;13;32;45
6;84;86;13;33;46
6;672;85;13;28;41
6;277;85;13;13;26
6;154;85;13;16;29
6;140;85;13;21;34
6;847;84;13;14;27
6;655;84;13;25;38
6;547;84;13;36;49
6;511;83;13;23;36
6;351;83;13;23;36
6;351;82;13;22;35
6;616;79;13;17;30
6;277;79;13;25;38
6;277;78;13;21;34
6;616;77;13;9;22
6;336;67;13;13;26
6;630;60;13;15;28
6;336;59;13;24;37
6;308;50;13;19;32
6;812;34;13;4;17
6;812;18;13;25;38
6;812;4;13;3;16
6;812;3;13;11;24
6;812;1;13;9;22
6;812;0;13;10;23
6;658;110;12;8;20
6;434;100;12;2;14
6;568;97;12;16;28
6;427;97;12;59;71
6;756;96;12;79;91
6;749;96;12;8;20
6;441;96;12;134;146
6;434;96;12;38;50
6;760;95;12;44;56
6;756;95;12;124;136
6;532;95;12;11;23
6;35;95;12;34;46
6;882;94;12;13;25
6;497;94;12;31;43
6;882;92;12;17;29
6;791;92;12;79;91
6;778;92;12;20;32
6;763;92;12;51;63
6;532;92;12;16;28
6;105;92;12;28;40
6;49;92;12;43;55
6;595;91;12;65;77
6;175;91;12;17;29
6;112;91;12;44;56
6;778;90;12;27;39
6;854;89;12;38;50
6;392;89;12;17;29
6;217;89;12;25;37
6;203;89;12;41;53
6;686;88;12;35;47
6;413;88;12;156;168
6;77;88;12;43;55
6;70;88;12;49;61
6;679;87;12;18;30
6;525;87;12;29;41
6;399;87;12;26;38
6;140;87;12;22;34
6;42;87;12;40;52
6;21;87;12;24;36
6;784;86;12;10;22
6;693;86;12;23;35
6;574;86;12;23;35
6;399;86;12;24;36
6;134;86;12;54;66
6;742;85;12;16;28
6;511;85;12;24;36
6;644;84;12;20;32
6;277;84;12;21;33
6;742;83;12;18;30
6;287;83;12;19;31
6;277;83;12;14;26
6;784;82;12;19;31
6;672;82;12;36;48
6;553;82;12;11;23
6;448;82;12;32;44
6;784;80;12;27;39
6;742;80;12;22;34
6;553;80;12;15;27
6;616;78;12;13;25
6;553;77;12;13;25
6;336;74;12;4;16
6;308;72;12;16;28
6;630;69;12;12;24
6;630;66;12;8;20
6;630;64;12;14;26
6;812;63;12;7;19
6;812;58;12;6;18
6;308;55;12;15;27
6;812;53;12;5;17
6;812;48;12;13;25
6;812;35;12;18;30
6;812;31;12;16;28
6;812;30;12;11;23
6;812;23;12;12;24
6;308;2;12;21;33
6;441;101;11;1;12
6;28;100;11;13;24
6;861;98;11;25;36
6;434;98;11;4;15
6;56;98;11;18;29
6;412;97;11;4;15
6;270;97;11;10;21
6;760;96;11;34;45
6;539;96;11;42;53
6;35;96;11;40;51
6;763;94;11;24;35
6;49;94;11;42;53
6;532;93;11;37;48
6;252;93;11;62;73
6;105;93;11;20;31
6;210;92;11;31;42
6;749;91;11;74;85
6;462;91;11;19;30
6;274;91;11;83;94
6;455;90;11;35;46
6;728;89;11;18;29
6;505;89;11;12;23
6;270;89;11;22;33
6;875;88;11;22;33
6;826;88;11;38;49
6;728;88;11;25;36
6;721;88;11;10;21
6;655;88;11;13;24
6;651;88;11;17;28
6;518;88;11;22;33
6;270;88;11;47;58
6;42;88;11;31;42
6;819;87;11;18;29
6;196;87;11;39;50
6;547;86;11;29;40
6;301;86;11;34;45
6;161;86;11;15;26
6;784;85;11;18;29
6;693;85;11;26;37
6;448;85;11;19;30
6;287;85;11;14;25
6;182;85;11;122;133
6;161;85;11;26;37
6;161;84;11;39;50
6;406;83;11;17;28
6;168;83;11;18;29
6;742;82;11;25;36
6;245;81;11;124;135
6;798;80;11;32;43
6;287;79;11;32;43
6;553;78;11;18;29
6;336;72;11;9;20
6;812;70;11;8;19
6;336;69;11;11;22
6;308;66;11;12;23
6;308;65;11;15;26
6;812;56;11;8;19
6;336;53;11;17;28
6;812;45;11;13;24
6;812;40;11;14;25
6;812;32;11;12;23
6;812;28;11;8;19
6;308;27;11;24;35
6;812;2;11;12;23
6;412;110;10;0;10
6;658;108;10;0;10
6;638;102;10;0;10
6;270;101;10;1;11
6;515;100;10;22;32
6;413;100;10;11;21
6;763;99;10;9;19
6;791;97;10;29;39
6;441;97;10;85;95
6;408;97;10;24;34
6;371;97;10;14;24
6;568;96;10;43;53
6;515;96;10;21;31
6;805;95;10;57;67
6;410;95;10;32;42
6;245;95;10;1;11
6;840;94;10;76;86
6;539;94;10;34;44
6;515;94;10;27;37
6;408;94;10;62;72
6;252;94;10;21;31
6;224;94;10;28;38
6;408;93;10;27;37
6;91;93;10;24;34
6;854;92;10;21;31
6;469;92;10;32;42
6;274;92;10;45;55
6;252;92;10;44;54
6;112;92;10;34;44
6;98;92;10;29;39
6;770;91;10;27;37
6;623;91;10;89;99
6;602;91;10;18;28
6;280;91;10;23;33
6;196;91;10;26;36
6;847;90;10;8;18
6;665;90;10;17;27
6;476;90;10;27;37
6;408;90;10;188;198
6;364;90;10;4;14
6;301;90;10;22;32
6;42;90;10;29;39
6;686;89;10;28;38
6;518;89;10;21;31
6;385;89;10;27;37
6;301;89;10;21;31
6;189;89;10;30;40
6;700;88;10;28;38
6;574;88;10;18;28
6;476;88;10;26;36
6;462;88;10;11;21
6;455;88;10;46;56
6;294;88;10;25;35
6;7;88;10;21;31
6;655;87;10;17;27
6;655;86;10;13;23
6;648;86;10;21;31
6;505;86;10;31;41
6;231;86;10;33;43
6;721;85;10;17;27
6;399;85;10;24;34
6;329;85;10;13;23
6;84;85;10;33;43
6;784;84;10;22;32
6;693;84;10;28;38
6;679;84;10;11;21
6;119;84;10;34;44
6;322;83;10;20;30
6;168;80;10;28;38
6;616;76;10;19;29
6;336;75;10;5;15
6;336;73;10;13;23
6;336;71;10;11;21
6;630;70;10;14;24
6;336;65;10;16;26
6;812;61;10;4;14
6;336;51;10;20;30
6;812;47;10;11;21
6;812;44;10;11;21
6;812;41;10;13;23
6;812;26;10;12;22
6;308;26;10;25;35
6;812;25;10;12;22
6;560;110;9;7;16
6;756;103;9;1;10
6;35;101;9;1;10
6;861;100;9;16;25
6;658;99;9;11;20
6;805;97;9;17;26
6;28;97;9;12;21
6;371;96;9;49;58
6;49;96;9;16;25
6;763;95;9;41;50
6;648;95;9;0;9
6;490;95;9;96;105
6;408;95;9;41;50
6;581;94;9;50;59
6;412;94;9;20;29
6;112;94;9;19;28
6;760;93;9;41;50
6;707;93;9;18;27
6;245;93;9;3;12
6;98;93;9;35;44
6;707;92;9;32;41
6;364;92;9;18;27
6;778;91;9;18;27
6;686;91;9;18;27
6;392;91;9;13;22
6;217;91;9;26;35
6;77;91;9;28;37
6;7;91;9;13;22
6;875;90;9;8;17
6;280;90;9;28;37
6;175;90;9;18;27
6;875;89;9;15;24
6;648;89;9;26;35
6;161;89;9;13;22
6;84;89;9;21;30
6;21;89;9;17;26
6;648;88;9;56;65
6;602;88;9;37;46
6;399;88;9;17;26
6;343;88;9;13;22
6;315;88;9;19;28
6;140;88;9;18;27
6;574;87;9;27;36
6;511;87;9;16;25
6;168;87;9;10;19
6;84;87;9;25;34
6;819;86;9;20;29
6;511;86;9;20;29
6;406;86;9;18;27
6;315;86;9;31;40
6;154;86;9;21;30
6;798;85;9;14;23
6;351;85;9;19;28
6;168;85;9;14;23
6;322;84;9;17;26
6;287;84;9;16;25
6;721;83;9;25;34
6;553;83;9;12;21
6;505;83;9;24;33
6;364;83;9;110;119
6;406;82;9;27;36
6;630;77;9;8;17
6;630;76;9;7;16
6;630;75;9;8;17
6;308;75;9;5;14
6;812;69;9;8;17
6;812;68;9;7;16
6;812;62;9;8;17
6;812;60;9;7;16
6;812;51;9;9;18
6;812;50;9;17;26
6;812;49;9;15;24
6;812;42;9;5;14
6;812;36;9;6;15
6;812;33;9;13;22
6;490;99;8;21;29
6;840;98;8;59;67
6;756;98;8;28;36
6;252;97;8;10;18
6;648;96;8;1;9
6;77;94;8;11;19
6;714;93;8;11;19
6;686;93;8;10;18
6;210;93;8;15;23
6;770;92;8;20;28
6;760;92;8;111;119
6;588;92;8;34;42
6;560;92;8;127;135
6;280;92;8;17;25
6;161;92;8;9;17
6;693;91;8;7;15
6;266;91;8;12;20
6;231;91;8;9;17
6;385;90;8;16;24
6;315;90;8;21;29
6;238;90;8;23;31
6;196;90;8;25;33
6;154;90;8;19;27
6;7;90;8;17;25
6;868;89;8;9;17
6;778;89;8;22;30
6;742;89;8;18;26
6;672;89;8;19;27
6;665;89;8;13;21
6;644;89;8;12;20
6;602;89;8;31;39
6;476;89;8;17;25
6;462;89;8;22;30
6;266;89;8;18;26
6;238;89;8;23;31
6;196;89;8;32;40
6;833;88;8;123;131
6;735;88;8;32;40
6;672;88;8;25;33
6;525;88;8;27;35
6;287;88;8;13;21
6;147;88;8;32;40
6;693;87;8;18;26
6;644;87;8;25;33
6;547;87;8;21;29
6;351;87;8;13;21
6;343;87;8;16;24
6;231;87;8;20;28
6;7;87;8;21;29
6;847;86;8;14;22
6;448;86;8;13;21
6;14;86;8;21;29
6;868;85;8;35;43
6;847;85;8;17;25
6;655;85;8;12;20
6;553;85;8;11;19
6;616;84;8;14;22
6;329;84;8;25;33
6;798;82;8;15;23
6;168;82;8;22;30
6;308;81;8;5;13
6;812;80;8;2;10
6;553;79;8;19;27
6;308;79;8;11;19
6;630;78;8;12;20
6;336;76;8;4;12
6;630;73;8;6;14
6;630;71;8;11;19
6;308;71;8;11;19
6;812;64;8;7;15
6;812;55;8;8;16
6;812;43;8;9;17
6;812;39;8;13;21
6;812;27;8;10;18
6;854;96;7;15;22
6;469;95;7;12;19
6;609;94;7;17;24
6;770;93;7;14;21
6;455;93;7;10;17
6;875;92;7;9;16
6;686;92;7;12;19
6;665;92;7;8;15
6;392;92;7;13;20
6;714;91;7;21;28
6;651;91;7;17;24
6;518;91;7;7;14
6;469;91;7;35;42
6;301;91;7;9;16
6;210;91;7;33;40
6;735;90;7;21;28
6;686;90;7;21;28
6;672;90;7;14;21
6;518;90;7;20;27
6;497;90;7;97;104
6;231;90;7;16;23
6;735;89;7;32;39
6;655;89;7;9;16
6;651;89;7;16;23
6;574;89;7;23;30
6;351;89;7;10;17
6;134;89;7;31;38
6;679;88;7;22;29
6;547;88;7;18;25
6;511;88;7;15;22
6;231;88;7;17;24
6;189;88;7;23;30
6;154;88;7;14;21
6;134;88;7;32;39
6;21;88;7;19;26
6;14;88;7;10;17
6;742;87;7;20;27
6;721;87;7;12;19
6;672;87;7;31;38
6;505;87;7;23;30
6;406;87;7;13;20
6;161;87;7;15;22
6;154;87;7;28;35
6;14;87;7;32;39
6;798;86;7;15;22
6;329;86;7;21;28
6;322;86;7;18;25
6;168;86;7;16;23
6;343;85;7;28;35
6;14;85;7;24;31
6;343;84;7;27;34
6;616;81;7;19;26
6;308;80;7;6;13
6;308;76;7;14;21
6;630;74;7;11;18
6;812;73;7;4;11
6;812;66;7;8;15
6;812;59;7;6;13
6;812;52;7;8;15
6;112;95;6;18;24
6;588;94;6;21;27
6;238;94;6;7;13
6;63;94;6;12;18
6;665;93;6;8;14
6;609;93;6;20;26
6;476;93;6;7;13
6;469;93;6;23;29
6;420;93;6;7;13
6;406;93;6;5;11
6;217;93;6;14;20
6;547;92;6;9;15
6;518;92;6;4;10
6;483;92;6;28;34
6;455;92;6;17;23
6;203;92;6;22;28
6;63;92;6;16;22
6;21;92;6;4;10
6;826;91;6;15;21
6;525;91;6;10;16
6;455;91;6;26;32
6;420;91;6;25;31
6;385;91;6;20;26
6;134;91;6;12;18
6;547;90;6;22;28
6;399;90;6;13;19
6;392;90;6;27;33
6;294;90;6;18;24
6;217;90;6;34;40
6;147;90;6;22;28
6;134;90;6;22;28
6;119;90;6;13;19
6;77;90;6;18;24
6;847;89;6;7;13
6;798;89;6;12;18
6;721;89;6;10;16
6;700;89;6;19;25
6;315;89;6;13;19
6;287;89;6;10;16
6;154;89;6;11;17
6;140;89;6;14;20
6;70;89;6;46;52
6;42;89;6;23;29
6;14;89;6;18;24
6;819;88;6;15;21
6;532;88;6;81;87
6;301;88;6;21;27
6;266;88;6;20;26
6;161;88;6;16;22
6;84;88;6;23;29
6;798;87;6;15;21
6;616;87;6;11;17
6;329;87;6;19;25
6;322;87;6;18;24
6;315;87;6;21;27
6;742;86;6;10;16
6;721;86;6;18;24
6;287;86;6;14;20
6;266;86;6;26;32
6;322;85;6;11;17
6;721;84;6;14;20
6;553;84;6;13;19
6;630;83;6;7;13
6;630;82;6;7;13
6;616;82;6;10;16
6;336;81;6;5;11
6;630;80;6;8;14
6;616;80;6;17;23
6;630;79;6;9;15
6;308;74;6;3;9
6;812;57;6;7;13
6;812;29;6;14;20
6;56;95;5;115;120
6;455;94;5;13;18
6;420;94;5;11;16
6;196;94;5;11;16
6;854;93;5;15;20
6;826;93;5;17;22
6;483;93;5;17;22
6;385;93;5;6;11
6;196;93;5;12;17
6;84;93;5;5;10
6;63;93;5;13;18
6;714;92;5;21;26
6;476;92;5;6;11
6;462;92;5;10;15
6;315;92;5;10;15
6;217;92;5;17;22
6;175;92;5;17;22
6;147;92;5;14;19
6;134;92;5;17;22
6;119;92;5;12;17
6;77;92;5;11;16
6;42;92;5;15;20
6;679;91;5;7;12
6;665;91;5;7;12
6;483;91;5;21;26
6;203;91;5;26;31
6;147;91;5;21;26
6;70;91;5;17;22
6;42;91;5;19;24
6;742;90;5;5;10
6;728;90;5;20;25
6;693;90;5;9;14
6;651;90;5;19;24
6;602;90;5;14;19
6;511;90;5;6;11
6;189;90;5;31;36
6;679;89;5;29;34
6;547;89;5;20;25
6;322;89;5;7;12
6;231;89;5;18;23
6;119;89;5;21;26
6;7;89;5;13;18
6;693;88;5;14;19
6;644;88;5;13;18
6;553;88;5;8;13
6;448;88;5;5;10
6;406;88;5;11;16
6;351;88;5;13;18
6;784;87;5;8;13
6;616;86;5;6;11
6;351;86;5;13;18
6;277;86;5;9;14
6;7;86;5;24;29
6;336;77;5;8;13
6;812;71;5;4;9
6;812;67;5;5;10
6;812;65;5;3;8
6;770;97;4;8;12
6;588;97;4;13;17
6;210;97;4;8;12
6;56;97;4;40;44
6;609;96;4;9;13
6;105;96;4;12;16
6;875;95;4;3;7
6;770;95;4;8;12
6;638;95;4;11;15
6;623;95;4;28;32
6;609;95;4;9;13
6;497;95;4;29;33
6;420;95;4;6;10
6;203;95;4;6;10
6;77;95;4;4;8
6;778;94;4;10;14
6;707;94;4;15;19
6;700;94;4;4;8
6;469;94;4;16;20
6;301;94;4;8;12
6;231;94;4;5;9
6;189;94;4;8;12
6;147;94;4;12;16
6;105;94;4;19;23
6;778;93;4;19;23
6;294;93;4;8;12
6;280;93;4;13;17
6;238;93;4;11;15
6;203;93;4;15;19
6;7;93;4;10;14
6;833;92;4;25;29
6;735;92;4;14;18
6;728;92;4;15;19
6;700;92;4;15;19
6;651;92;4;18;22
6;638;92;4;45;49
6;609;92;4;29;33
6;420;92;4;18;22
6;385;92;4;9;13
6;329;92;4;4;8
6;238;92;4;17;21
6;196;92;4;17;21
6;189;92;4;10;14
6;14;92;4;8;12
6;875;91;4;17;21
6;868;91;4;8;12
6;735;91;4;16;20
6;581;91;4;41;45
6;336;91;4;1;5
6;315;91;4;16;20
6;294;91;4;17;21
6;238;91;4;22;26
6;189;91;4;9;13
6;119;91;4;11;15
6;868;90;4;12;16
6;819;90;4;11;15
6;525;90;4;13;17
6;462;90;4;14;18
6;161;90;4;13;17
6;140;90;4;6;10
6;819;89;4;8;12
6;693;89;4;13;17
6;294;89;4;20;24
6;175;89;4;25;29
6;168;89;4;9;13
6;847;88;4;9;13
6;798;88;4;11;15
6;329;88;4;15;19
6;322;88;4;8;12
6;553;87;4;5;9
6;287;87;4;11;15
6;553;86;4;12;16
6;308;85;4;4;8
6;119;85;4;25;29
6;616;83;4;9;13
6;812;78;4;6;10
6;679;102;3;0;3
6;778;99;3;1;4
6;112;99;3;3;6
6;410;98;3;14;17
6;210;98;3;5;8
6;854;97;3;7;10
6;420;97;3;3;6
6;154;97;3;4;7
6;63;97;3;5;8
6;588;96;3;10;13
6;483;96;3;4;7
6;469;96;3;7;10
6;280;96;3;9;12
6;203;96;3;5;8
6;196;96;3;9;12
6;112;96;3;5;8
6;7;96;3;3;6
6;854;95;3;18;21
6;819;95;3;6;9
6;714;95;3;10;13
6;644;95;3;3;6
6;602;95;3;6;9
6;511;95;3;5;8
6;476;95;3;7;10
6;392;95;3;5;8
6;351;95;3;2;5
6;224;95;3;13;16
6;217;95;3;11;14
6;210;95;3;10;13
6;147;95;3;4;7
6;70;95;3;5;8
6;854;94;3;16;19
6;826;94;3;14;17
6;749;94;3;50;53
6;714;94;3;8;11
6;623;94;3;36;39
6;547;94;3;5;8
6;483;94;3;16;19
6;217;94;3;11;14
6;210;94;3;14;17
6;154;94;3;9;12
6;119;94;3;5;8
6;70;94;3;6;9
6;21;94;3;5;8
6;14;94;3;6;9
6;875;93;3;5;8
6;735;93;3;14;17
6;679;93;3;4;7
6;651;93;3;8;11
6;638;93;3;47;50
6;602;93;3;14;17
6;511;93;3;7;10
6;399;93;3;5;8
6;392;93;3;13;16
6;343;93;3;3;6
6;277;93;3;0;3
6;231;93;3;5;8
6;154;93;3;8;11
6;147;93;3;15;18
6;112;93;3;11;14
6;77;93;3;10;13
6;826;92;3;12;15
6;742;92;3;6;9
6;721;92;3;3;6
6;644;92;3;5;8
6;602;92;3;13;16
6;511;92;3;7;10
6;406;92;3;6;9
6;399;92;3;9;12
6;301;92;3;11;14
6;140;92;3;7;10
6;126;92;3;13;16
6;70;92;3;16;19
6;7;92;3;16;19
6;784;91;3;6;9
6;742;91;3;6;9
6;728;91;3;19;22
6;721;91;3;4;7
6;655;91;3;5;8
6;574;91;3;7;10
6;505;91;3;10;13
6;476;91;3;10;13
6;399;91;3;12;15
6;343;91;3;12;15
6;182;91;3;49;52
6;154;91;3;9;12
6;140;91;3;12;15
6;21;91;3;8;11
6;14;91;3;7;10
6;798;90;3;5;8
6;791;90;3;145;148
6;784;90;3;11;14
6;351;90;3;6;9
6;266;90;3;9;12
6;245;90;3;40;43
6;14;90;3;10;13
6;630;89;3;3;6
6;616;89;3;8;11
6;511;89;3;19;22
6;448;89;3;12;15
6;406;89;3;10;13
6;399;89;3;9;12
6;742;88;3;10;13
6;168;88;3;11;14
6;308;87;3;4;7
6;630;86;3;4;7
6;630;85;3;6;9
6;336;84;3;4;7
6;336;83;3;3;6
6;336;82;3;5;8
6;336;80;3;3;6
6;812;79;3;4;7
6;336;78;3;6;9
6;308;78;3;6;9
6;812;75;3;4;7
6;308;73;3;12;15
6;812;72;3;3;6
6;630;72;3;8;11
6;638;110;2;1;3
6;658;109;2;0;2
6;749;101;2;0;2
6;588;101;2;1;3
6;441;100;2;39;41
6;210;100;2;1;3
6;861;99;2;16;18
6;749;99;2;2;4
6;707;99;2;4;6
6;568;99;2;15;17
6;427;99;2;64;66
6;410;99;2;5;7
6;175;99;2;0;2
6;28;99;2;14;16
6;854;98;2;5;7
6;665;98;2;3;5
6;574;98;2;1;3
6;568;98;2;20;22
6;287;98;2;2;4
6;238;98;2;3;5
6;203;98;2;0;2
6;63;98;2;2;4
6;7;98;2;0;2
6;833;97;2;2;4
6;756;97;2;33;35
6;686;97;2;3;5
6;609;97;2;3;5
6;574;97;2;5;7
6;505;97;2;2;4
6;483;97;2;5;7
6;469;97;2;8;10
6;217;97;2;6;8
6;875;96;2;4;6
6;826;96;2;6;8
6;805;96;2;25;27
6;791;96;2;1;3
6;770;96;2;8;10
6;707;96;2;12;14
6;658;96;2;46;48
6;581;96;2;6;8
6;532;96;2;22;24
6;490;96;2;79;81
6;410;96;2;26;28
6;343;96;2;2;4
6;294;96;2;3;5
6;231;96;2;0;2
6;210;96;2;9;11
6;175;96;2;5;7
6;161;96;2;3;5
6;119;96;2;4;6
6;77;96;2;8;10
6;70;96;2;4;6
6;840;95;2;38;40
6;833;95;2;15;17
6;686;95;2;8;10
6;574;95;2;3;5
6;294;95;2;5;7
6;280;95;2;3;5
6;231;95;2;1;3
6;189;95;2;3;5
6;161;95;2;0;2
6;134;95;2;7;9
6;105;95;2;7;9
6;84;95;2;6;8
6;63;95;2;11;13
6;49;95;2;32;34
6;42;95;2;6;8
6;819;94;2;4;6
6;798;94;2;5;7
6;770;94;2;18;20
6;735;94;2;9;11
6;679;94;2;1;3
6;672;94;2;6;8
6;665;94;2;5;7
6;616;94;2;1;3
6;525;94;2;4;6
6;462;94;2;5;7
6;410;94;2;52;54
6;399;94;2;7;9
6;322;94;2;1;3
6;294;94;2;10;12
6;280;94;2;11;13
6;203;94;2;19;21
6;175;94;2;8;10
6;140;94;2;5;7
6;134;94;2;4;6
6;84;94;2;6;8
6;7;94;2;5;7
6;882;93;2;34;36
6;868;93;2;6;8
6;847;93;2;3;5
6;763;93;2;35;37
6;728;93;2;7;9
6;700;93;2;9;11
6;547;93;2;11;13
6;505;93;2;2;4
6;462;93;2;10;12
6;364;93;2;50;52
6;308;93;2;5;7
6;301;93;2;7;9
6;224;93;2;4;6
6;189;93;2;14;16
6;175;93;2;13;15
6;140;93;2;7;9
6;134;93;2;9;11
6;70;93;2;12;14
6;49;93;2;12;14
6;42;93;2;15;17
6;14;93;2;11;13
6;847;92;2;8;10
6;784;92;2;3;5
6;693;92;2;5;7
6;679;92;2;4;6
6;616;92;2;4;6
6;574;92;2;5;7
6;525;92;2;8;10
6;505;92;2;7;9
6;497;92;2;26;28
6;343;92;2;9;11
6;277;92;2;5;7
6;168;92;2;5;7
6;819;91;2;12;14
6;798;91;2;9;11
6;700;91;2;19;21
6;672;91;2;15;17
6;616;91;2;5;7
6;547;91;2;17;19
6;532;91;2;36;38
6;497;91;2;45;47
6;448;91;2;7;9
6;329;91;2;9;11
6;322;91;2;10;12
6;287;91;2;6;8
6;277;91;2;7;9
6;270;91;2;13;15
6;168;91;2;4;6
6;126;91;2;41;43
6;98;91;2;25;27
6;679;90;2;10;12
6;655;90;2;6;8
6;574;90;2;14;16
6;505;90;2;7;9
6;406;90;2;13;15
6;343;90;2;10;12
6;329;90;2;9;11
6;287;90;2;8;10
6;21;90;2;16;18
6;784;89;2;7;9
6;553;89;2;2;4
6;343;89;2;11;13
6;329;89;2;15;17
6;784;88;2;7;9
6;638;88;2;69;71
6;630;88;2;3;5
6;616;88;2;5;7
6;505;88;2;10;12
6;336;88;2;5;7
6;308;88;2;3;5
6;812;87;2;2;4
6;630;87;2;3;5
6;448;87;2;17;19
6;277;87;2;13;15
6;308;86;2;4;6
6;616;85;2;10;12
6;336;85;2;4;6
6;630;84;2;4;6
6;308;84;2;8;10
6;630;81;2;10;12
6;336;79;2;4;6
6;812;77;2;2;4
6;812;76;2;4;6
6;812;74;2;4;6
6;805;110;1;0;1
6;778;110;1;0;1
6;742;110;1;0;1
6;568;110;1;0;1
6;469;110;1;0;1
6;357;110;1;10;11
6;134;110;1;0;1
6;56;110;1;1;2
6;28;110;1;0;1
6;882;109;1;0;1
6;462;109;1;0;1
6;441;109;1;0;1
6;412;109;1;0;1
6;770;107;1;0;1
6;672;107;1;0;1
6;434;107;1;0;1
6;760;106;1;0;1
6;588;106;1;0;1
6;420;106;1;0;1
6;294;106;1;0;1
6;763;105;1;0;1
6;28;105;1;0;1
6;638;104;1;0;1
6;497;104;1;0;1
6;448;104;1;0;1
6;868;103;1;0;1
6;778;103;1;0;1
6;483;103;1;1;2
6;315;103;1;0;1
6;854;102;1;0;1
6;588;102;1;0;1
6;574;102;1;0;1
6;462;102;1;0;1
6;441;102;1;2;3
6;399;102;1;0;1
6;210;102;1;0;1
6;882;101;1;0;1
6;805;101;1;1;2
6;756;101;1;3;4
6;707;101;1;0;1
6;638;101;1;0;1
6;623;101;1;82;83
6;581;101;1;0;1
6;469;101;1;2;3
6;399;101;1;1;2
6;277;101;1;0;1
6;224;101;1;1;2
6;217;101;1;0;1
6;63;101;1;1;2
6;840;100;1;9;10
6;833;100;1;0;1
6;770;100;1;0;1
6;742;100;1;1;2
6;707;100;1;1;2
6;658;100;1;17;18
6;638;100;1;11;12
6;602;100;1;0;1
6;588;100;1;5;6
6;490;100;1;33;34
6;412;100;1;0;1
6;399;100;1;0;1
6;357;100;1;46;47
6;343;100;1;0;1
6;301;100;1;1;2
6;294;100;1;1;2
6;270;100;1;1;2
6;252;100;1;0;1
6;245;100;1;0;1
6;175;100;1;1;2
6;134;100;1;0;1
6;112;100;1;2;3
6;84;100;1;0;1
6;882;99;1;1;2
6;854;99;1;0;1
6;826;99;1;0;1
6;756;99;1;22;23
6;728;99;1;6;7
6;655;99;1;1;2
6;595;99;1;8;9
6;588;99;1;2;3
6;574;99;1;0;1
6;469;99;1;3;4
6;385;99;1;1;2
6;364;99;1;1;2
6;315;99;1;0;1
6;56;99;1;6;7
6;35;99;1;3;4
6;14;99;1;0;1
6;805;98;1;45;46
6;784;98;1;0;1
6;778;98;1;5;6
6;707;98;1;5;6
6;672;98;1;1;2
6;651;98;1;3;4
6;644;98;1;2;3
6;623;98;1;11;12
6;609;98;1;3;4
6;525;98;1;2;3
6;518;98;1;1;2
6;497;98;1;10;11
6;462;98;1;2;3
6;408;98;1;9;10
6;322;98;1;0;1
6;294;98;1;1;2
6;245;98;1;13;14
6;217;98;1;1;2
6;112;98;1;9;10
6;105;98;1;5;6
6;91;98;1;10;11
6;42;98;1;3;4
6;21;98;1;0;1
6;875;97;1;1;2
6;798;97;1;1;2
6;778;97;1;3;4
6;763;97;1;10;11
6;760;97;1;7;8
6;735;97;1;5;6
6;728;97;1;3;4
6;707;97;1;9;10
6;655;97;1;2;3
6;651;97;1;2;3
6;602;97;1;2;3
6;595;97;1;15;16
6;581;97;1;14;15
6;553;97;1;0;1
6;547;97;1;5;6
6;525;97;1;5;6
6;518;97;1;2;3
6;511;97;1;3;4
6;462;97;1;2;3
6;455;97;1;3;4
6;434;97;1;31;32
6;399;97;1;3;4
6;385;97;1;8;9
6;343;97;1;2;3
6;322;97;1;1;2
6;301;97;1;3;4
6;294;97;1;0;1
6;287;97;1;4;5
6;196;97;1;8;9
6;168;97;1;3;4
6;161;97;1;3;4
6;147;97;1;6;7
6;105;97;1;6;7
6;98;97;1;16;17
6;84;97;1;4;5
6;70;97;1;2;3
6;49;97;1;14;15
6;35;97;1;24;25
6;833;96;1;3;4
6;819;96;1;2;3
6;798;96;1;1;2
6;763;96;1;6;7
6;742;96;1;0;1
6;735;96;1;5;6
6;721;96;1;3;4
6;700;96;1;3;4
6;693;96;1;1;2
6;672;96;1;4;5
6;644;96;1;0;1
6;602;96;1;2;3
6;574;96;1;5;6
6;511;96;1;0;1
6;497;96;1;3;4
6;476;96;1;3;4
6;420;96;1;8;9
6;413;96;1;19;20
6;301;96;1;3;4
6;277;96;1;1;2
6;274;96;1;12;13
6;252;96;1;19;20
6;238;96;1;6;7
6;224;96;1;6;7
6;217;96;1;8;9
6;134;96;1;4;5
6;98;96;1;12;13
6;84;96;1;4;5
6;63;96;1;10;11
6;42;96;1;2;3
6;826;95;1;6;7
6;791;95;1;8;9
6;749;95;1;42;43
6;728;95;1;4;5
6;655;95;1;5;6
6;651;95;1;6;7
6;616;95;1;2;3
6;588;95;1;8;9
6;581;95;1;58;59
6;560;95;1;2;3
6;547;95;1;2;3
6;525;95;1;6;7
6;515;95;1;23;24
6;505;95;1;2;3
6;483;95;1;9;10
6;455;95;1;8;9
6;448;95;1;3;4
6;412;95;1;1;2
6;399;95;1;6;7
6;336;95;1;0;1
6;322;95;1;8;9
6;315;95;1;3;4
6;287;95;1;2;3
6;277;95;1;4;5
6;270;95;1;12;13
6;266;95;1;6;7
6;260;95;1;25;26
6;196;95;1;6;7
6;154;95;1;3;4
6;119;95;1;0;1
6;21;95;1;0;1
6;868;94;1;2;3
6;791;94;1;55;56
6;784;94;1;2;3
6;728;94;1;6;7
6;686;94;1;12;13
6;655;94;1;2;3
6;651;94;1;15;16
6;644;94;1;3;4
6;595;94;1;26;27
6;574;94;1;6;7
6;553;94;1;0;1
6;518;94;1;3;4
6;511;94;1;4;5
6;505;94;1;3;4
6;448;94;1;2;3
6;406;94;1;5;6
6;385;94;1;9;10
6;371;94;1;58;59
6;364;94;1;15;16
6;351;94;1;1;2
6;329;94;1;4;5
6;315;94;1;3;4
6;270;94;1;10;11
6;266;94;1;8;9
6;182;94;1;1;2
6;161;94;1;8;9
6;126;94;1;25;26
6;833;93;1;25;26
6;819;93;1;6;7
6;812;93;1;0;1
6;742;93;1;1;2
6;672;93;1;6;7
6;648;93;1;1;2
6;644;93;1;5;6
6;574;93;1;7;8
6;525;93;1;7;8
6;515;93;1;44;45
6;412;93;1;37;38
6;351;93;1;5;6
6;322;93;1;6;7
6;315;93;1;5;6
6;270;93;1;33;34
6;266;93;1;7;8
6;260;93;1;43;44
6;168;93;1;0;1
6;21;93;1;10;11
6;868;92;1;8;9
6;798;92;1;3;4
6;553;92;1;4;5
6;413;92;1;50;51
6;351;92;1;6;7
6;322;92;1;6;7
6;308;92;1;1;2
6;294;92;1;10;11
6;287;92;1;5;6
6;270;92;1;7;8
6;266;92;1;5;6
6;245;92;1;12;13
6;231;92;1;12;13
6;182;92;1;37;38
6;154;92;1;5;6
6;84;92;1;16;17
6;847;91;1;11;12
6;760;91;1;79;80
6;644;91;1;8;9
6;630;91;1;1;2
6;553;91;1;4;5
6;511;91;1;8;9
6;406;91;1;10;11
6;351;91;1;3;4
6;161;91;1;8;9
6;84;91;1;17;18
6;49;91;1;24;25
6;721;90;1;11;12
6;644;90;1;10;11
6;630;90;1;1;2
6;616;90;1;1;2
6;553;90;1;3;4
6;532;90;1;25;26
6;448;90;1;9;10
6;336;90;1;2;3
6;322;90;1;13;14
6;308;90;1;2;3
6;168;90;1;8;9
6;308;89;1;2;3
6;812;88;1;0;1
6;847;87;1;17;18
6;648;87;1;47;48
6;336;87;1;5;6
6;812;86;1;1;2
6;336;86;1;4;5
6;812;84;1;3;4
6;308;83;1;4;5
6;308;82;1;4;5
6;812;81;1;4;5
6;868;110;0;1;1
6;854;110;0;1;1
6;840;110;0;11;11
6;763;110;0;1;1
6;756;110;0;10;10
6;539;110;0;1;1
6;427;110;0;13;13
6;280;110;0;1;1
6;274;110;0;10;10
6;756;109;0;1;1
6;568;109;0;8;8
6;399;109;0;1;1
6;308;108;0;1;1
6;483;107;0;1;1
6;455;107;0;1;1
6;413;107;0;1;1
6;252;107;0;1;1
6;224;107;0;1;1
6;98;107;0;3;3
6;861;106;0;2;2
6;833;106;0;1;1
6;749;106;0;2;2
6;560;106;0;9;9
6;518;106;0;1;1
6;441;106;0;1;1
6;427;106;0;10;10
6;315;106;0;1;1
6;134;106;0;1;1
6;98;106;0;1;1
6;861;105;0;1;1
6;791;105;0;1;1
6;749;105;0;1;1
6;658;105;0;2;2
6;483;105;0;1;1
6;427;105;0;1;1
6;410;105;0;10;10
6;408;105;0;1;1
6;357;105;0;1;1
6;224;105;0;1;1
6;70;105;0;1;1
6;700;104;0;1;1
6;686;104;0;1;1
6;672;104;0;1;1
6;511;104;0;1;1
6;441;104;0;1;1
6;427;104;0;1;1
6;410;104;0;9;9
6;308;104;0;1;1
6;203;104;0;1;1
6;35;104;0;1;1
6;28;104;0;1;1
6;21;104;0;2;2
6;861;103;0;2;2
6;840;103;0;1;1
6;805;103;0;8;8
6;749;103;0;10;10
6;707;103;0;1;1
6;658;103;0;10;10
6;539;103;0;1;1
6;497;103;0;1;1
6;490;103;0;6;6
6;441;103;0;10;10
6;410;103;0;1;1
6;408;103;0;1;1
6;392;103;0;1;1
6;357;103;0;1;1
6;343;103;0;1;1
6;301;103;0;1;1
6;294;103;0;1;1
6;270;103;0;1;1
6;134;103;0;1;1
6;91;103;0;1;1
6;84;103;0;1;1
6;70;103;0;1;1
6;63;103;0;1;1
6;56;103;0;1;1
6;42;103;0;1;1
6;35;103;0;1;1
6;28;103;0;1;1
6;14;103;0;1;1
6;882;102;0;1;1
6;861;102;0;2;2
6;840;102;0;1;1
6;805;102;0;1;1
6;791;102;0;1;1
6;760;102;0;2;2
6;756;102;0;1;1
6;749;102;0;1;1
6;686;102;0;2;2
6;665;102;0;1;1
6;658;102;0;9;9
6;568;102;0;9;9
6;547;102;0;1;1
6;539;102;0;1;1
6;532;102;0;1;1
6;490;102;0;2;2
6;455;102;0;2;2
6;434;102;0;22;22
6;427;102;0;28;28
6;420;102;0;1;1
6;413;102;0;2;2
6;410;102;0;1;1
6;364;102;0;1;1
6;274;102;0;13;13
6;224;102;0;9;9
6;217;102;0;1;1
6;203;102;0;1;1
6;196;102;0;1;1
6;134;102;0;1;1
6;126;102;0;1;1
6;112;102;0;1;1
6;98;102;0;1;1
6;77;102;0;1;1
6;56;102;0;1;1
6;42;102;0;2;2
6;35;102;0;1;1
6;21;102;0;1;1
6;861;101;0;1;1
6;854;101;0;2;2
6;847;101;0;1;1
6;840;101;0;2;2
6;833;101;0;3;3
6;770;101;0;1;1
6;728;101;0;2;2
6;714;101;0;2;2
6;700;101;0;1;1
6;672;101;0;2;2
6;665;101;0;2;2
6;658;101;0;2;2
6;655;101;0;1;1
6;609;101;0;1;1
6;574;101;0;1;1
6;553;101;0;1;1
6;539;101;0;11;11
6;515;101;0;9;9
6;505;101;0;1;1
6;497;101;0;2;2
6;490;101;0;2;2
6;483;101;0;1;1
6;455;101;0;1;1
6;427;101;0;28;28
6;408;101;0;2;2
6;371;101;0;10;10
6;357;101;0;3;3
6;351;101;0;2;2
6;315;101;0;1;1
6;308;101;0;1;1
6;274;101;0;1;1
6;252;101;0;10;10
6;231;101;0;1;1
6;203;101;0;2;2
6;175;101;0;1;1
6;161;101;0;1;1
6;147;101;0;1;1
6;140;101;0;1;1
6;134;101;0;1;1
6;112;101;0;1;1
6;105;101;0;1;1
6;98;101;0;1;1
6;70;101;0;1;1
6;56;101;0;2;2
6;49;101;0;1;1
6;28;101;0;10;10
6;21;101;0;2;2
6;14;101;0;1;1
6;875;100;0;1;1
6;854;100;0;3;3
6;826;100;0;1;1
6;798;100;0;1;1
6;791;100;0;12;12
6;778;100;0;3;3
6;763;100;0;1;1
6;760;100;0;17;17
6;756;100;0;3;3
6;749;100;0;1;1
6;728;100;0;2;2
6;714;100;0;2;2
6;686;100;0;2;2
6;665;100;0;1;1
6;655;100;0;1;1
6;651;100;0;1;1
6;623;100;0;15;15
6;609;100;0;1;1
6;595;100;0;2;2
6;568;100;0;5;5
6;547;100;0;2;2
6;539;100;0;13;13
6;511;100;0;1;1
6;497;100;0;1;1
6;483;100;0;1;1
6;469;100;0;1;1
6;455;100;0;3;3
6;427;100;0;40;40
6;420;100;0;2;2
6;410;100;0;3;3
6;392;100;0;2;2
6;385;100;0;3;3
6;371;100;0;10;10
6;351;100;0;1;1
6;322;100;0;2;2
6;315;100;0;1;1
6;280;100;0;1;1
6;274;100;0;12;12
6;266;100;0;1;1
6;238;100;0;1;1
6;231;100;0;1;1
6;224;100;0;2;2
6;217;100;0;2;2
6;203;100;0;1;1
6;182;100;0;1;1
6;105;100;0;3;3
6;77;100;0;2;2
6;63;100;0;1;1
6;56;100;0;15;15
6;35;100;0;24;24
6;14;100;0;2;2
6;868;99;0;2;2
6;840;99;0;13;13
6;833;99;0;10;10
6;819;99;0;3;3
6;805;99;0;11;11
6;784;99;0;2;2
6;770;99;0;6;6
6;760;99;0;12;12
6;742;99;0;1;1
6;735;99;0;2;2
6;721;99;0;1;1
6;714;99;0;1;1
6;700;99;0;1;1
6;693;99;0;1;1
6;686;99;0;1;1
6;672;99;0;2;2
6;665;99;0;1;1
6;651;99;0;1;1
6;644;99;0;2;2
6;638;99;0;1;1
6;616;99;0;2;2
6;581;99;0;2;2
6;539;99;0;9;9
6;532;99;0;11;11
6;525;99;0;2;2
6;518;99;0;1;1
6;497;99;0;22;22
6;483;99;0;1;1
6;462;99;0;1;1
6;441;99;0;25;25
6;434;99;0;13;13
6;420;99;0;1;1
6;399;99;0;1;1
6;392;99;0;1;1
6;371;99;0;2;2
6;357;99;0;17;17
6;351;99;0;1;1
6;343;99;0;1;1
6;329;99;0;1;1
6;287;99;0;1;1
6;280;99;0;1;1
6;274;99;0;10;10
6;270;99;0;11;11
6;266;99;0;2;2
6;260;99;0;1;1
6;252;99;0;1;1
6;238;99;0;3;3
6;224;99;0;13;13
6;217;99;0;1;1
6;210;99;0;2;2
6;203;99;0;2;2
6;196;99;0;1;1
6;189;99;0;1;1
6;161;99;0;1;1
6;154;99;0;1;1
6;147;99;0;1;1
6;140;99;0;2;2
6;119;99;0;3;3
6;105;99;0;4;4
6;98;99;0;12;12
6;91;99;0;1;1
6;84;99;0;2;2
6;77;99;0;3;3
6;70;99;0;2;2
6;63;99;0;4;4
6;49;99;0;16;16
6;42;99;0;2;2
6;7;99;0;1;1
6;882;98;0;1;1
6;875;98;0;1;1
6;868;98;0;1;1
6;847;98;0;1;1
6;833;98;0;2;2
6;791;98;0;21;21
6;770;98;0;2;2
6;763;98;0;1;1
6;760;98;0;7;7
6;749;98;0;3;3
6;742;98;0;1;1
6;735;98;0;2;2
6;728;98;0;2;2
6;721;98;0;3;3
6;714;98;0;1;1
6;700;98;0;1;1
6;686;98;0;4;4
6;658;98;0;35;35
6;655;98;0;1;1
6;638;98;0;15;15
6;616;98;0;1;1
6;602;98;0;4;4
6;595;98;0;11;11
6;588;98;0;7;7
6;581;98;0;4;4
6;560;98;0;1;1
6;547;98;0;1;1
6;532;98;0;11;11
6;515;98;0;30;30
6;511;98;0;1;1
6;505;98;0;1;1
6;483;98;0;5;5
6;476;98;0;3;3
6;469;98;0;4;4
6;455;98;0;1;1
6;441;98;0;56;56
6;427;98;0;49;49
6;420;98;0;3;3
6;413;98;0;11;11
6;412;98;0;1;1
6;406;98;0;1;1
6;399;98;0;1;1
6;392;98;0;3;3
6;385;98;0;2;2
6;371;98;0;31;31
6;364;98;0;1;1
6;357;98;0;43;43
6;351;98;0;1;1
6;343;98;0;3;3
6;329;98;0;1;1
6;308;98;0;1;1
6;301;98;0;1;1
6;280;98;0;5;5
6;274;98;0;1;1
6;266;98;0;2;2
6;260;98;0;2;2
6;252;98;0;9;9
6;231;98;0;1;1
6;224;98;0;15;15
6;196;98;0;5;5
6;189;98;0;3;3
6;175;98;0;5;5
6;161;98;0;1;1
6;154;98;0;1;1
6;147;98;0;1;1
6;140;98;0;5;5
6;126;98;0;1;1
6;98;98;0;2;2
6;84;98;0;4;4
6;70;98;0;9;9
6;49;98;0;12;12
6;882;97;0;1;1
6;868;97;0;3;3
6;861;97;0;65;65
6;847;97;0;1;1
6;826;97;0;4;4
6;784;97;0;1;1
6;749;97;0;25;25
6;742;97;0;1;1
6;721;97;0;2;2
6;714;97;0;3;3
6;700;97;0;6;6
6;679;97;0;8;8
6;672;97;0;3;3
6;665;97;0;6;6
6;648;97;0;11;11
6;638;97;0;3;3
6;623;97;0;26;26
6;616;97;0;1;1
6;560;97;0;1;1
6;539;97;0;21;21
6;532;97;0;23;23
6;515;97;0;24;24
6;497;97;0;22;22
6;476;97;0;6;6
6;406;97;0;1;1
6;364;97;0;2;2
6;329;97;0;4;4
6;315;97;0;2;2
6;280;97;0;2;2
6;277;97;0;1;1
6;274;97;0;22;22
6;266;97;0;3;3
6;260;97;0;4;4
6;238;97;0;2;2
6;231;97;0;2;2
6;224;97;0;22;22
6;203;97;0;2;2
6;189;97;0;3;3
6;182;97;0;9;9
6;175;97;0;3;3
6;140;97;0;3;3
6;134;97;0;2;2
6;126;97;0;17;17
6;119;97;0;3;3
6;112;97;0;6;6
6;91;97;0;9;9
6;77;97;0;2;2
6;42;97;0;4;4
6;21;97;0;1;1
6;14;97;0;2;2
6;7;97;0;2;2
6;882;96;0;12;12
6;868;96;0;3;3
6;784;96;0;5;5
6;778;96;0;6;6
6;728;96;0;9;9
6;714;96;0;7;7
6;686;96;0;2;2
6;679;96;0;2;2
6;665;96;0;6;6
6;651;96;0;6;6
6;638;96;0;30;30
6;630;96;0;1;1
6;616;96;0;1;1
6;595;96;0;6;6
6;560;96;0;9;9
6;553;96;0;1;1
6;547;96;0;5;5
6;525;96;0;6;6
6;518;96;0;6;6
6;505;96;0;2;2
6;462;96;0;5;5
6;455;96;0;3;3
6;448;96;0;2;2
6;412;96;0;11;11
6;406;96;0;2;2
6;399;96;0;2;2
6;392;96;0;1;1
6;385;96;0;5;5
6;364;96;0;2;2
6;351;96;0;1;1
6;322;96;0;4;4
6;315;96;0;7;7
6;287;96;0;2;2
6;266;96;0;4;4
6;260;96;0;13;13
6;245;96;0;23;23
6;189;96;0;6;6
6;168;96;0;4;4
6;154;96;0;1;1
6;147;96;0;15;15
6;140;96;0;1;1
6;126;96;0;6;6
6;21;96;0;3;3
6;14;96;0;1;1
6;868;95;0;4;4
6;847;95;0;2;2
6;798;95;0;2;2
6;784;95;0;2;2
6;778;95;0;5;5
6;742;95;0;4;4
6;735;95;0;4;4
6;721;95;0;1;1
6;707;95;0;6;6
6;700;95;0;5;5
6;693;95;0;3;3
6;679;95;0;1;1
6;672;95;0;5;5
6;665;95;0;10;10
6;595;95;0;26;26
6;518;95;0;4;4
6;462;95;0;7;7
6;434;95;0;92;92
6;406;95;0;7;7
6;385;95;0;9;9
6;364;95;0;10;10
6;343;95;0;5;5
6;329;95;0;1;1
6;308;95;0;1;1
6;301;95;0;6;6
6;274;95;0;52;52
6;252;95;0;28;28
6;238;95;0;10;10
6;182;95;0;21;21
6;175;95;0;14;14
6;168;95;0;1;1
6;140;95;0;4;4
6;126;95;0;12;12
6;98;95;0;15;15
6;91;95;0;12;12
6;14;95;0;3;3
6;7;95;0;5;5
6;875;94;0;3;3
6;847;94;0;2;2
6;742;94;0;4;4
6;721;94;0;2;2
6;693;94;0;5;5
6;648;94;0;1;1
6;630;94;0;2;2
6;602;94;0;12;12
6;532;94;0;29;29
6;476;94;0;4;4
6;413;94;0;33;33
6;392;94;0;12;12
6;343;94;0;4;4
6;308;94;0;1;1
6;287;94;0;1;1
6;277;94;0;2;2
6;245;94;0;12;12
6;168;94;0;4;4
6;42;94;0;13;13
6;798;93;0;4;4
6;784;93;0;2;2
6;721;93;0;8;8
6;655;93;0;4;4
6;616;93;0;5;5
6;560;93;0;39;39
6;518;93;0;6;6
6;497;93;0;34;34
6;448;93;0;3;3
6;413;93;0;57;57
6;336;93;0;1;1
6;329;93;0;2;2
6;287;93;0;6;6
6;274;93;0;41;41
6;182;93;0;44;44
6;161;93;0;5;5
6;119;93;0;13;13
6;819;92;0;5;5
6;672;92;0;14;14
6;655;92;0;4;4
6;630;92;0;2;2
6;448;92;0;6;6
6;412;92;0;56;56
6;408;92;0;40;40
6;336;92;0;1;1
6;812;91;0;1;1
6;648;91;0;27;27
6;412;91;0;25;25
6;364;91;0;29;29
6;308;91;0;2;2
6;812;90;0;2;2
6;277;90;0;4;4
6;336;89;0;1;1
6;277;89;0;7;7
6;277;88;0;16;16
6;812;83;0;3;3
6;812;82;0;4;4
6;648;82;0;53;53
10;49;17;1725;1540;3265
10;49;10;1638;1574;3212
10;49;12;1631;1651;3282
10;49;15;1619;1554;3173
10;49;19;1591;1694;3285
10;49;14;1562;1602;3164
10;49;9;1553;1595;3148
10;49;11;1548;1450;2998
10;49;8;1542;1277;2819
10;49;1;1503;1383;2886
10;49;16;1480;1435;2915
10;49;21;1472;1165;2637
10;49;18;1453;1475;2928
10;49;28;1442;1173;2615
10;49;22;1435;1266;2701
10;49;20;1434;1439;2873
10;49;30;1402;1243;2645
10;49;35;1393;1232;2625
10;49;13;1388;1546;2934
10;49;6;1386;1401;2787
10;49;33;1382;1382;2764
10;49;27;1368;1253;2621
10;49;25;1368;1405;2773
10;49;2;1365;1492;2857
10;49;4;1338;1518;2856
10;49;3;1333;1472;2805
10;49;7;1294;1504;2798
10;49;24;1273;1399;2672
10;49;0;1256;1343;2599
10;49;31;1239;1285;2524
10;49;29;1201;1383;2584
10;49;32;1196;1332;2528
10;49;34;1188;1415;2603
10;49;23;1169;1598;2767
10;49;26;1155;1382;2537
10;49;36;1144;1107;2251
10;49;5;1140;1576;2716
10;49;39;1084;1089;2173
10;49;40;1044;856;1900
10;49;37;1000;1115;2115
10;49;48;938;991;1929
10;49;41;909;850;1759
10;49;38;890;985;1875
10;49;50;876;723;1599
10;49;46;847;690;1537
10;49;51;814;776;1590
10;49;47;814;883;1697
10;49;49;765;865;1630
10;49;42;761;939;1700
10;49;55;745;774;1519
10;49;60;741;661;1402
10;49;45;729;883;1612
10;49;43;709;1048;1757
10;49;57;657;739;1396
10;49;58;650;750;1400
10;49;52;635;828;1463
10;49;44;628;900;1528
10;49;53;615;773;1388
10;49;54;608;890;1498
10;49;61;567;612;1179
10;49;62;564;610;1174
10;49;59;557;761;1318
10;49;56;552;900;1452
10;49;63;466;546;1012
10;49;65;452;485;937
10;49;64;426;574;1000
10;49;68;375;475;850
10;49;67;359;464;823
10;35;13;337;301;638
10;35;15;331;326;657
10;112;14;324;301;625
10;105;15;321;266;587
10;35;16;317;281;598
10;35;12;314;292;606
10;35;11;313;302;615
10;105;14;310;258;568
10;112;10;310;301;611
10;105;12;307;264;571
10;70;14;302;262;564
10;35;14;301;271;572
10;70;8;301;263;564
10;112;15;300;316;616
10;35;18;295;252;547
10;112;17;295;268;563
10;35;4;295;282;577
10;105;16;294;240;534
10;70;10;294;255;549
10;112;7;294;268;562
10;91;15;293;296;589
10;91;11;293;251;544
10;35;10;291;280;571
10;49;66;288;462;750
10;91;10;288;241;529
10;49;69;286;336;622
10;35;17;286;319;605
10;70;15;285;259;544
10;35;2;285;279;564
10;112;11;284;269;553
10;70;9;283;256;539
10;35;7;283;278;561
10;35;19;281;222;503
10;112;9;281;303;584
10;35;8;281;272;553
10;91;12;278;248;526
10;70;7;278;257;535
10;112;12;277;289;566
10;35;3;277;279;556
10;91;17;274;268;542
10;70;11;273;258;531
10;112;8;272;295;567
10;70;16;271;249;520
10;70;17;270;223;493
10;91;14;270;294;564
10;105;18;269;210;479
10;35;30;266;177;443
10;112;18;265;270;535
10;91;9;265;250;515
10;112;16;264;296;560
10;105;9;264;244;508
10;49;72;263;395;658
10;112;3;263;233;496
10;91;13;262;281;543
10;35;0;262;241;503
10;35;33;261;167;428
10;112;6;261;260;521
10;91;16;260;234;494
10;105;13;260;238;498
10;70;13;259;238;497
10;35;23;258;246;504
10;112;19;258;235;493
10;91;8;257;207;464
10;112;0;256;258;514
10;49;76;255;212;467
10;35;9;254;302;556
10;35;6;254;290;544
10;35;5;254;273;527
10;49;70;251;486;737
10;35;32;249;200;449
10;112;5;249;248;497
10;35;31;248;180;428
10;112;20;248;206;454
10;70;12;246;273;519
10;112;4;246;238;484
10;112;24;245;235;480
10;35;34;244;194;438
10;112;2;244;253;497
10;105;8;241;219;460
10;105;6;241;213;454
10;35;35;240;200;440
10;35;1;240;240;480
10;105;17;239;272;511
10;21;10;239;223;462
10;112;13;236;269;505
10;70;2;232;225;457
10;35;21;230;199;429
10;105;11;230;244;474
10;35;29;226;205;431
10;112;30;225;243;468
10;112;22;224;226;450
10;35;24;223;180;403
10;70;19;223;195;418
10;70;5;223;210;433
10;35;20;222;227;449
10;91;7;222;235;457
10;112;21;221;192;413
10;21;13;221;199;420
10;70;4;221;226;447
10;112;33;220;231;451
10;35;25;220;192;412
10;105;5;220;228;448
10;105;7;218;208;426
10;70;6;218;224;442
10;70;1;218;197;415
10;21;12;217;209;426
10;105;10;217;222;439
10;112;1;216;242;458
10;112;28;215;214;429
10;35;26;215;210;425
10;105;1;215;184;399
10;112;32;214;216;430
10;70;3;214;199;413
10;112;34;213;256;469
10;70;18;213;238;451
10;21;7;212;180;392
10;91;3;212;188;400
10;35;27;211;197;408
10;21;15;211;183;394
10;35;37;210;166;376
10;112;35;209;208;417
10;112;27;209;217;426
10;112;25;209;207;416
10;21;11;208;221;429
10;105;4;208;223;431
10;105;3;208;207;415
10;35;36;207;151;358
10;112;31;207;217;424
10;91;2;206;202;408
10;70;20;205;214;419
10;91;6;205;196;401
10;91;18;204;217;421
10;112;26;203;192;395
10;112;23;202;194;396
10;105;19;202;206;408
10;35;38;201;191;392
10;42;9;201;174;375
10;91;5;201;203;404
10;105;2;201;183;384
10;112;36;200;208;408
10;49;77;198;327;525
10;21;16;198;182;380
10;112;29;197;216;413
10;35;28;196;193;389
10;49;75;195;348;543
10;70;0;194;198;392
10;49;71;193;313;506
10;91;20;193;187;380
10;21;18;193;193;386
10;21;8;192;199;391
10;70;32;191;156;347
10;21;9;190;200;390
10;91;4;190;197;387
10;21;14;188;220;408
10;42;8;187;165;352
10;42;10;186;158;344
10;112;38;183;205;388
10;35;22;183;210;393
10;21;6;183;170;353
10;91;1;183;181;364
10;112;37;182;200;382
10;42;15;182;175;357
10;91;0;182;195;377
10;105;20;180;174;354
10;42;18;180;177;357
10;112;41;179;162;341
10;42;14;179;184;363
10;42;11;179;184;363
10;21;17;178;188;366
10;70;29;177;142;319
10;105;0;177;199;376
10;112;39;175;184;359
10;42;16;175;169;344
10;42;13;175;193;368
10;21;19;174;151;325
10;21;1;173;153;326
10;49;79;171;267;438
10;105;23;171;137;308
10;91;19;171;164;335
10;21;2;171;167;338
10;70;30;169;193;362
10;42;7;169;173;342
10;21;4;169;166;335
10;91;30;167;190;357
10;35;42;166;126;292
10;42;12;166;152;318
10;70;21;165;162;327
10;49;78;164;253;417
10;70;24;164;169;333
10;21;3;164;157;321
10;70;31;163;171;334
10;35;39;162;158;320
10;42;6;161;164;325
10;35;41;159;147;306
10;35;40;159;174;333
10;42;17;159;191;350
10;49;74;158;291;449
10;42;30;158;133;291
10;70;34;157;166;323
10;91;24;157;185;342
10;105;21;156;134;290
10;42;21;156;123;279
10;42;20;156;106;262
10;42;5;156;149;305
10;21;0;156;148;304
10;112;40;155;188;343
10;42;22;155;126;281
10;98;10;154;113;267
10;112;42;153;140;293
10;70;35;153;167;320
10;70;27;153;154;307
10;84;15;153;107;260
10;42;0;153;130;283
10;70;25;152;160;312
10;70;23;152;161;313
10;105;34;151;125;276
10;70;33;151;162;313
10;91;21;151;150;301
10;42;19;151;166;317
10;42;3;151;138;289
10;35;45;150;130;280
10;105;32;150;157;307
10;21;5;150;156;306
10;35;46;149;118;267
10;112;44;149;174;323
10;70;41;149;119;268
10;70;28;149;182;331
10;98;17;149;117;266
10;105;30;148;175;323
10;91;25;148;144;292
10;105;22;148;158;306
10;63;14;148;123;271
10;91;37;147;153;300
10;91;22;147;168;315
10;70;22;147;162;309
10;42;28;146;132;278
10;105;25;146;150;296
10;105;33;145;175;320
10;42;33;145;127;272
10;105;24;145;164;309
10;42;1;145;149;294
10;105;35;144;147;291
10;91;34;144;147;291
10;21;30;144;136;280
10;91;28;144;156;300
10;42;23;144;118;262
10;84;17;144;106;250
10;98;8;144;127;271
10;112;50;143;130;273
10;112;45;143;169;312
10;105;37;143;131;274
10;84;11;143;125;268
10;91;39;142;127;269
10;105;28;142;148;290
10;21;27;142;129;271
10;21;20;142;118;260
10;70;37;141;124;265
10;105;36;141;161;302
10;91;35;141;160;301
10;21;35;141;113;254
10;42;29;141;114;255
10;91;26;141;164;305
10;35;50;140;120;260
10;112;46;140;140;280
10;35;43;140;142;282
10;70;39;140;144;284
10;91;29;140;137;277
10;105;26;140;133;273
10;98;16;140;113;253
10;63;16;140;128;268
10;98;13;140;135;275
10;63;12;140;113;253
10;35;49;139;145;284
10;70;36;139;131;270
10;42;32;139;96;235
10;70;26;139;170;309
10;21;23;139;118;257
10;98;12;139;134;273
10;84;7;139;125;264
10;42;4;139;145;284
10;35;44;138;128;266
10;70;38;138;163;301
10;42;27;137;105;242
10;42;24;137;133;270
10;112;43;136;138;274
10;91;33;136;181;317
10;91;32;136;170;306
10;42;25;136;103;239
10;21;21;136;119;255
10;63;10;136;141;277
10;84;9;136;127;263
10;42;26;135;127;262
10;98;15;134;132;266
10;98;14;134;149;283
10;84;10;134;113;247
10;42;2;134;146;280
10;105;39;133;133;266
10;91;23;133;162;295
10;21;22;133;119;252
10;98;9;133;144;277
10;98;7;133;121;254
10;35;59;132;79;211
10;35;51;132;106;238
10;105;40;132;123;255
10;91;40;131;128;259
10;42;35;131;112;243
10;98;18;131;105;236
10;63;2;131;96;227
10;105;50;130;110;240
10;70;43;129;103;232
10;105;38;129;114;243
10;42;34;129;94;223
10;21;31;129;146;275
10;105;29;129;144;273
10;21;24;129;116;245
10;63;9;129;127;256
10;84;8;129;128;257
10;70;52;128;82;210
10;70;49;128;91;219
10;35;48;128;130;258
10;42;31;128;136;264
10;98;5;128;96;224
10;84;5;128;110;238
10;70;53;127;95;222
10;91;50;127;136;263
10;112;49;127;128;255
10;112;47;127;127;254
10;21;29;127;137;264
10;84;12;127;113;240
10;49;73;126;231;357
10;112;52;126;127;253
10;21;33;126;133;259
10;98;11;126;137;263
10;105;42;125;135;260
10;70;40;125;155;280
10;63;15;125;118;243
10;63;6;125;97;222
10;35;54;124;113;237
10;112;48;124;142;266
10;105;46;124;128;252
10;63;20;124;94;218
10;35;47;123;113;236
10;21;28;123;136;259
10;63;7;123;118;241
10;91;38;122;123;245
10;105;31;122;146;268
10;35;58;121;107;228
10;91;44;121;119;240
10;70;42;121;120;241
10;91;31;121;166;287
10;84;14;121;117;238
10;112;55;120;127;247
10;70;44;120;105;225
10;98;4;120;104;224
10;84;0;120;102;222
10;112;54;119;115;234
10;112;53;119;117;236
10;112;51;119;125;244
10;21;26;119;125;244
10;84;1;119;107;226
10;63;0;119;125;244
10;21;32;118;146;264
10;91;27;118;137;255
10;98;3;118;137;255
10;63;3;118;116;234
10;35;56;117;114;231
10;35;52;117;108;225
10;21;38;117;102;219
10;63;18;117;123;240
10;98;2;117;85;202
10;49;84;116;138;254
10;70;47;116;121;237
10;91;36;116;129;245
10;98;19;116;92;208
10;63;11;116;103;219
10;84;2;116;99;215
10;91;46;115;133;248
10;98;20;115;113;228
10;35;55;114;101;215
10;21;25;114;107;221
10;91;52;113;96;209
10;70;51;113;98;211
10;70;50;113;106;219
10;105;41;113;130;243
10;63;17;113;114;227
10;112;58;112;112;224
10;91;49;112;101;213
10;84;4;112;110;222
10;35;53;111;118;229
10;105;49;111;91;202
10;91;47;111;120;231
10;84;6;111;110;221
10;105;44;110;101;211
10;98;28;110;108;218
10;98;22;110;79;189
10;91;45;109;123;232
10;21;37;109;113;222
10;21;36;109;94;203
10;98;30;109;103;212
10;98;24;109;93;202
10;35;60;108;110;218
10;112;56;108;113;221
10;91;51;108;107;215
10;105;43;108;107;215
10;42;41;108;81;189
10;105;27;108;129;237
10;84;18;108;103;211
10;63;8;108;116;224
10;98;6;108;127;235
10;112;60;107;98;205
10;91;43;107;134;241
10;84;3;107;92;199
10;105;48;106;111;217
10;70;46;106;99;205
10;105;45;106;87;193
10;98;32;106;79;185
10;63;19;106;117;223
10;63;5;106;103;209
10;70;54;105;106;211
10;70;48;105;93;198
10;21;43;105;87;192
10;91;42;105;119;224
10;21;39;105;124;229
10;70;58;104;96;200
10;21;45;104;90;194
10;84;13;104;124;228
10;112;62;103;79;182
10;105;54;103;86;189
10;105;53;103;89;192
10;70;45;103;122;225
10;63;13;103;110;213
10;21;51;102;80;182
10;42;40;102;72;174
10;84;16;102;122;224
10;35;57;101;110;211
10;105;47;101;95;196
10;98;27;101;89;190
10;98;1;101;109;210
10;35;61;100;101;201
10;105;59;100;87;187
10;105;58;100;79;179
10;91;57;100;112;212
10;91;53;100;108;208
10;42;48;100;73;173
10;21;40;100;123;223
10;63;39;100;84;184
10;49;82;99;192;291
10;112;57;99;100;199
10;91;56;99;108;207
10;91;55;99;103;202
10;63;32;99;93;192
10;63;30;99;109;208
10;91;48;98;106;204
10;21;34;98;129;227
10;63;28;98;86;184
10;98;23;98;93;191
10;70;60;97;69;166
10;98;26;97;73;170
10;63;4;97;87;184
10;21;42;96;111;207
10;42;36;96;98;194
10;63;33;96;90;186
10;21;48;95;83;178
10;49;80;94;208;302
10;21;50;94;92;186
10;21;46;94;97;191
10;98;35;94;69;163
10;98;25;94;71;165
10;63;23;94;91;185
10;63;21;94;101;195
10;49;85;93;175;268
10;91;54;93;92;185
10;98;21;93;89;182
10;63;24;92;95;187
10;98;0;92;106;198
10;105;57;91;81;172
10;105;56;91;103;194
10;21;41;91;98;189
10;42;38;91;85;176
10;63;37;91;85;176
10;35;62;90;84;174
10;70;55;90;96;186
10;21;54;90;68;158
10;105;52;90;120;210
10;42;45;90;64;154
10;42;39;90;81;171
10;112;61;89;99;188
10;105;61;89;82;171
10;21;55;89;77;166
10;63;26;89;92;181
10;112;59;88;108;196
10;105;51;88;108;196
10;21;49;88;81;169
10;21;44;88;81;169
10;98;31;88;83;171
10;63;1;88;80;168
10;91;60;87;76;163
10;70;57;87;59;146
10;42;53;87;71;158
10;42;42;87;81;168
10;91;41;87;153;240
10;98;36;87;82;169
10;63;25;87;90;177
10;63;22;87;90;177
10;84;21;87;79;166
10;105;64;86;76;162
10;105;60;86;95;181
10;21;60;86;66;152
10;42;50;86;63;149
10;63;47;86;55;141
10;105;63;85;84;169
10;91;58;85;102;187
10;105;55;85;99;184
10;21;53;85;71;156
10;63;34;85;102;187
10;70;56;84;69;153
10;42;37;84;84;168
10;98;29;84;94;178
10;42;55;83;50;133
10;98;33;83;81;164
10;84;29;83;77;160
10;84;24;83;67;150
10;49;81;82;262;344
10;91;59;82;68;150
10;42;52;82;64;146
10;84;30;82;82;164
10;21;57;81;77;158
10;42;47;81;82;163
10;42;44;81;90;171
10;42;43;81;67;148
10;63;40;81;76;157
10;84;35;81;59;140
10;63;35;81;89;170
10;84;31;81;78;159
10;63;31;81;86;167
10;91;64;80;74;154
10;84;44;80;42;122
10;63;27;80;85;165
10;63;29;79;116;195
10;84;27;79;69;148
10;84;26;79;76;155
10;84;19;79;93;172
10;35;63;78;87;165
10;21;58;77;94;171
10;84;32;77;87;164
10;70;65;76;63;139
10;35;65;76;78;154
10;35;64;76;89;165
10;70;62;76;66;142
10;91;61;76;87;163
10;84;33;76;80;156
10;112;65;75;90;165
10;91;62;75;72;147
10;21;61;75;53;128
10;21;56;75;80;155
10;98;34;75;106;181
10;105;66;74;71;145
10;105;65;74;67;141
10;91;65;74;86;160
10;63;42;74;66;140
10;98;41;74;68;142
10;105;62;73;72;145
10;70;59;73;72;145
10;42;56;73;59;132
10;21;52;73;76;149
10;84;38;73;67;140
10;98;37;73;66;139
10;84;28;73;84;157
10;84;25;73;80;153
10;91;63;72;63;135
10;70;63;72;51;123
10;42;51;72;74;146
10;42;49;72;62;134
10;63;36;72;87;159
10;49;83;71;253;324
10;98;40;71;62;133
10;84;34;71;75;146
10;42;57;70;59;129
10;21;47;70;84;154
10;98;39;70;66;136
10;84;22;70;51;121
10;42;58;69;51;120
10;98;43;69;57;126
10;84;43;69;45;114
10;70;61;68;59;127
10;63;46;68;51;119
10;98;45;68;40;108
10;98;44;68;48;116
10;63;44;68;70;138
10;35;70;67;89;156
10;84;40;67;54;121
10;84;23;67;77;144
10;84;20;67;78;145
10;70;66;66;44;110
10;112;64;66;79;145
10;98;47;66;39;105
10;21;66;65;66;131
10;42;60;65;47;112
10;98;51;65;51;116
10;105;68;64;65;129
10;42;54;64;60;124
10;42;46;64;77;141
10;77;12;64;34;98
10;112;66;63;68;131
10;98;57;63;51;114
10;63;48;63;59;122
10;84;42;63;51;114
10;84;39;63;67;130
10;63;38;63;84;147
10;105;67;62;79;141
10;21;65;62;53;115
10;21;64;62;52;114
10;21;59;62;62;124
10;98;55;62;40;102
10;35;69;61;69;130
10;112;63;61;80;141
10;42;59;61;59;120
10;21;69;60;46;106
10;91;67;60;62;122
10;70;67;60;66;126
10;63;50;60;48;108
10;98;42;60;59;119
10;84;37;60;52;112
10;91;71;59;48;107
10;105;69;59;56;115
10;91;68;59;50;109
10;91;66;59;74;133
10;98;52;59;48;107
10;98;50;59;51;110
10;63;45;59;52;111
10;63;41;59;83;142
10;84;36;59;81;140
10;70;64;58;68;126
10;98;54;58;53;111
10;98;53;58;47;105
10;63;53;58;51;109
10;98;49;58;54;112
10;84;45;58;49;107
10;63;43;58;85;143
10;112;68;57;61;118
10;35;67;57;69;126
10;21;62;57;58;115
10;63;55;57;54;111
10;98;48;57;54;111
10;84;41;57;62;119
10;98;38;57;66;123
10;91;72;56;56;112
10;35;68;56;72;128
10;112;67;56;69;125
10;42;67;56;49;105
10;42;63;56;31;87
10;42;62;56;36;92
10;98;60;56;41;97
10;98;46;56;47;103
10;70;69;55;56;111
10;35;66;55;62;117
10;42;65;55;60;115
10;63;56;55;53;108
10;63;54;55;47;102
10;63;49;55;51;106
10;105;71;54;59;113
10;84;54;54;36;90
10;112;70;53;62;115
10;84;60;53;30;83
10;98;59;53;38;91
10;84;51;53;45;98
10;7;14;52;48;100
10;77;10;52;45;97
10;77;9;52;57;109
10;35;75;51;50;101
10;105;70;51;60;111
10;42;61;51;60;111
10;63;51;51;56;107
10;84;46;51;40;91
10;7;11;51;50;101
10;7;10;51;29;80
10;56;6;51;42;93
10;91;73;50;60;110
10;91;70;50;63;113
10;91;69;50;60;110
10;98;56;50;43;93
10;84;53;50;27;77
10;84;49;50;42;92
10;77;15;50;36;86
10;77;14;50;39;89
10;21;63;49;65;114
10;63;57;49;42;91
10;84;50;49;49;98
10;35;74;48;52;100
10;35;73;48;59;107
10;84;47;48;50;98
10;77;28;48;24;72
10;7;15;48;44;92
10;77;13;48;36;84
10;42;64;47;40;87
10;77;7;47;52;99
10;56;3;47;29;76
10;70;70;46;50;96
10;63;59;46;50;96
10;7;33;46;27;73
10;77;18;46;32;78
10;77;16;46;44;90
10;105;73;45;55;100
10;70;73;45;41;86
10;21;67;45;51;96
10;42;66;45;37;82
10;84;52;45;48;93
10;84;48;45;47;92
10;49;87;44;88;132
10;21;74;44;49;93
10;70;71;44;40;84
10;70;68;44;61;105
10;84;58;44;38;82
10;7;16;44;37;81
10;63;58;43;58;101
10;84;57;43;31;74
10;63;52;43;58;101
10;77;21;43;27;70
10;56;18;43;26;69
10;14;13;43;34;77
10;7;13;43;52;95
10;56;11;43;34;77
10;77;8;43;46;89
10;7;3;43;28;71
10;105;77;42;52;94
10;91;74;42;52;94
10;112;72;42;55;97
10;105;72;42;52;94
10;21;68;42;55;97
10;98;62;42;37;79
10;63;61;42;41;83
10;84;56;42;38;80
10;56;13;42;37;79
10;49;88;41;84;125
10;91;76;41;58;99
10;35;71;41;57;98
10;21;70;41;33;74
10;112;69;41;68;109
10;63;60;41;46;87
10;98;58;41;38;79
10;84;55;41;46;87
10;77;19;41;34;75
10;77;17;41;42;83
10;56;12;41;31;72
10;14;12;41;31;72
10;56;10;41;37;78
10;56;9;41;35;76
10;7;9;41;46;87
10;7;8;41;41;82
10;91;78;40;55;95
10;35;76;40;48;88
10;84;59;40;28;68
10;7;31;40;35;75
10;7;29;40;33;73
10;7;20;40;28;68
10;91;79;39;45;84
10;112;75;39;44;83
10;63;62;39;29;68
10;98;61;39;28;67
10;7;17;39;42;81
10;56;14;39;33;72
10;56;4;39;38;77
10;105;80;38;45;83
10;98;63;38;34;72
10;14;17;38;30;68
10;14;16;38;24;62
10;14;14;38;31;69
10;56;5;38;30;68
10;77;0;38;40;78
10;91;75;37;57;94
10;70;75;37;28;65
10;21;73;37;42;79
10;112;71;37;44;81
10;84;65;37;28;65
10;63;64;37;34;71
10;63;63;37;34;71
10;7;55;37;16;53
10;77;23;37;29;66
10;7;19;37;35;72
10;7;18;37;41;78
10;77;3;37;25;62
10;56;2;37;34;71
10;35;77;36;47;83
10;112;73;36;52;88
10;70;72;36;43;79
10;35;72;36;49;85
10;42;68;36;29;65
10;84;64;36;27;63
10;77;37;36;24;60
10;77;35;36;33;69
10;7;27;36;37;73
10;14;10;36;37;73
10;56;8;36;42;78
10;14;3;36;20;56
10;77;2;36;19;55
10;98;71;35;25;60
10;42;71;35;30;65
10;98;66;35;29;64
10;98;65;35;34;69
10;98;64;35;38;73
10;77;32;35;32;67
10;7;30;35;29;64
10;7;28;35;40;75
10;56;15;35;33;68
10;7;7;35;35;70
10;77;1;35;34;69
10;105;78;34;38;72
10;112;77;34;45;79
10;105;76;34;46;80
10;105;75;34;56;90
10;105;74;34;50;84
10;42;69;34;32;66
10;63;66;34;31;65
10;7;26;34;26;60
10;77;20;34;22;56
10;77;4;34;27;61
10;35;78;33;55;88
10;21;72;33;35;68
10;98;68;33;23;56
10;84;68;33;25;58
10;84;63;33;25;58
10;7;50;33;21;54
10;7;48;33;20;53
10;7;46;33;17;50
10;77;45;33;18;51
10;7;21;33;35;68
10;56;16;33;24;57
10;7;12;33;44;77
10;14;11;33;36;69
10;70;74;32;37;69
10;21;71;32;41;73
10;63;65;32;37;69
10;7;45;32;18;50
10;77;34;32;22;54
10;7;32;32;25;57
10;14;8;32;45;77
10;105;81;31;36;67
10;42;72;31;19;50
10;84;69;31;35;66
10;84;66;31;27;58
10;84;62;31;27;58
10;14;42;31;16;47
10;7;38;31;28;59
10;56;27;31;22;53
10;7;25;31;37;68
10;7;2;31;25;56
10;21;79;30;37;67
10;21;78;30;37;67
10;70;77;30;33;63
10;112;74;30;45;75
10;84;61;30;28;58
10;7;56;30;26;56
10;77;55;30;16;46
10;7;54;30;20;50
10;7;47;30;25;55
10;77;39;30;23;53
10;77;31;30;35;65
10;77;11;30;46;76
10;7;6;30;25;55
10;7;0;30;32;62
10;91;80;29;40;69
10;105;79;29;50;79
10;70;78;29;35;64
10;98;67;29;25;54
10;77;56;29;18;47
10;7;49;29;32;61
10;14;34;29;18;47
10;56;33;29;15;44
10;77;29;29;25;54
10;56;26;29;24;53
10;77;24;29;32;61
10;7;23;29;20;49
10;91;81;28;25;53
10;70;76;28;31;59
10;7;59;28;20;48
10;77;53;28;16;44
10;56;46;28;14;42
10;77;38;28;30;58
10;56;35;28;24;52
10;77;25;28;33;61
10;56;24;28;23;51
10;7;22;28;17;45
10;56;7;28;41;69
10;112;78;27;39;66
10;21;75;27;35;62
10;63;70;27;24;51
10;56;59;27;15;42
10;7;58;27;15;42
10;56;48;27;22;49
10;56;38;27;23;50
10;77;36;27;20;47
10;56;29;27;31;58
10;14;29;27;22;49
10;7;24;27;34;61
10;77;22;27;24;51
10;56;20;27;16;43
10;14;15;27;28;55
10;14;7;27;38;65
10;77;6;27;35;62
10;56;1;27;37;64
10;7;1;27;38;65
10;21;80;26;22;48
10;91;77;26;49;75
10;98;74;26;15;41
10;98;70;26;26;52
10;98;69;26;33;59
10;84;67;26;31;57
10;7;66;26;11;37
10;7;52;26;18;44
10;7;40;26;30;56
10;7;37;26;20;46
10;7;35;26;31;57
10;7;34;26;25;51
10;77;30;26;40;66
10;77;27;26;22;48
10;56;19;26;28;54
10;28;10;26;5;31
10;14;6;26;34;60
10;7;4;26;41;67
10;35;82;25;33;58
10;84;75;25;22;47
10;84;72;25;22;47
10;77;57;25;16;41
10;14;55;25;6;31
10;7;51;25;22;47
10;56;31;25;25;50
10;56;30;25;29;54
10;14;26;25;14;39
10;56;23;25;19;44
10;14;20;25;23;48
10;14;9;25;32;57
10;14;5;25;21;46
10;14;4;25;29;54
10;56;0;25;30;55
10;105;84;24;29;53
10;91;82;24;37;61
10;98;78;24;21;45
10;98;73;24;22;46
10;84;70;24;31;55
10;42;70;24;26;50
10;56;63;24;9;33
10;77;51;24;24;48
10;14;51;24;5;29
10;77;49;24;12;36
10;77;47;24;17;41
10;77;43;24;29;53
10;56;42;24;19;43
10;14;32;24;22;46
10;56;17;24;30;54
10;28;9;24;16;40
10;7;5;24;40;64
10;14;1;24;21;45
10;105;82;23;53;76
10;35;81;23;49;72
10;112;76;23;44;67
10;98;75;23;23;46
10;42;75;23;30;53
10;63;67;23;27;50
10;7;65;23;16;39
10;7;61;23;16;39
10;77;58;23;23;46
10;56;51;23;19;42
10;77;50;23;23;46
10;77;46;23;17;40
10;7;43;23;27;50
10;7;42;23;16;39
10;7;41;23;29;52
10;7;39;23;25;48
10;56;37;23;20;43
10;56;36;23;23;46
10;77;33;23;33;56
10;28;32;23;8;31
10;14;31;23;27;50
10;14;30;23;22;45
10;14;22;23;13;36
10;14;0;23;10;33
10;91;85;22;28;50
10;21;81;22;29;51
10;98;76;22;17;39
10;21;76;22;37;59
10;7;71;22;14;36
10;77;67;22;12;34
10;56;61;22;14;36
10;56;47;22;14;36
10;14;43;22;9;31
10;56;34;22;29;51
10;14;33;22;17;39
10;28;31;22;5;27
10;56;28;22;29;51
10;14;23;22;10;32
10;56;21;22;18;40
10;14;19;22;14;36
10;77;5;22;25;47
10;49;90;21;38;59
10;35;83;21;32;53
10;112;81;21;30;51
10;42;81;21;19;40
10;35;80;21;49;70
10;42;79;21;21;42
10;21;77;21;33;54
10;7;60;21;20;41
10;56;53;21;9;30
10;56;52;21;17;38
10;14;50;21;8;29
10;77;42;21;18;39
10;77;40;21;13;34
10;56;40;21;13;34
10;7;36;21;23;44
10;28;7;21;13;34
10;14;2;21;26;47
10;49;89;20;77;97
10;35;84;20;37;57
10;42;82;20;14;34
10;98;77;20;12;32
10;42;77;20;26;46
10;63;73;20;22;42
10;63;71;20;20;40
10;63;68;20;37;57
10;77;64;20;17;37
10;7;63;20;17;37
10;77;60;20;14;34
10;7;57;20;25;45
10;56;49;20;12;32
10;56;43;20;7;27
10;56;32;20;25;45
10;14;24;20;15;35
10;56;22;20;29;49
10;98;79;19;16;35
10;70;79;19;27;46
10;35;79;19;45;64
10;42;74;19;21;40
10;98;72;19;24;43
10;56;71;19;13;32
10;7;70;19;15;34
10;77;69;19;19;38
10;77;61;19;16;35
10;7;53;19;23;42
10;14;49;19;16;35
10;77;48;19;19;38
10;77;44;19;13;32
10;14;41;19;11;30
10;14;40;19;17;36
10;56;39;19;16;35
10;14;37;19;16;35
10;14;18;19;23;42
10;28;1;19;11;30
10;91;83;18;39;57
10;112;79;18;38;56
10;84;74;18;25;43
10;84;71;18;24;42
10;56;70;18;5;23
10;77;66;18;9;27
10;14;61;18;8;26
10;56;58;18;14;32
10;7;44;18;23;41
10;56;41;18;19;37
10;28;36;18;8;26
10;14;35;18;17;35
10;28;33;18;8;26
10;28;28;18;10;28
10;14;28;18;19;37
10;77;26;18;20;38
10;14;25;18;15;33
10;28;14;18;13;31
10;28;12;18;12;30
10;28;8;18;18;36
10;112;80;17;25;42
10;98;80;17;20;37
10;63;75;17;19;36
10;7;68;17;18;35
10;7;64;17;25;42
10;56;60;17;13;30
10;77;59;17;22;39
10;14;59;17;8;25
10;56;57;17;12;29
10;56;55;17;10;27
10;14;48;17;21;38
10;14;46;17;17;34
10;14;45;17;13;30
10;56;44;17;5;22
10;14;36;17;15;32
10;28;15;17;13;30
10;28;13;17;18;35
10;91;88;16;24;40
10;105;86;16;22;38
10;105;83;16;34;50
10;21;83;16;29;45
10;98;82;16;10;26
10;42;80;16;12;28
10;84;77;16;16;32
10;42;76;16;25;41
10;7;74;16;12;28
10;84;73;16;18;34
10;63;69;16;27;43
10;77;63;16;20;36
10;14;60;16;11;27
10;14;58;16;5;21
10;56;56;16;18;34
10;56;50;16;12;28
10;77;41;16;21;37
10;14;38;16;12;28
10;28;34;16;8;24
10;28;29;16;14;30
10;28;27;16;16;32
10;28;26;16;10;26
10;28;16;16;11;27
10;28;6;16;17;33
10;28;2;16;5;21
10;49;86;15;144;159
10;112;85;15;31;46
10;91;84;15;27;42
10;84;82;15;7;22
10;84;81;15;15;30
10;70;81;15;29;44
10;70;80;15;33;48
10;42;78;15;21;36
10;77;71;15;15;30
10;7;69;15;17;32
10;77;65;15;8;23
10;77;54;15;20;35
10;28;50;15;3;18
10;56;45;15;24;39
10;14;39;15;9;24
10;28;3;15;15;30
10;49;95;14;0;14
10;105;92;14;7;21
10;91;90;14;18;32
10;112;82;14;27;41
10;63;82;14;17;31
10;84;80;14;16;30
10;84;79;14;30;44
10;7;77;14;8;22
10;84;76;14;26;40
10;63;76;14;19;33
10;63;74;14;24;38
10;56;68;14;7;21
10;56;67;14;6;20
10;56;65;14;17;31
10;77;62;14;20;34
10;14;56;14;10;24
10;14;54;14;16;30
10;77;52;14;15;29
10;14;52;14;13;27
10;28;44;14;4;18
10;28;23;14;9;23
10;14;21;14;17;31
10;42;83;13;7;20
10;63;80;13;14;27
10;63;78;13;24;37
10;63;77;13;19;32
10;77;75;13;8;21
10;77;74;13;8;21
10;56;73;13;5;18
10;42;73;13;23;36
10;14;69;13;7;20
10;56;64;13;12;25
10;56;62;13;14;27
10;14;62;13;9;22
10;7;62;13;12;25
10;14;53;13;7;20
10;14;47;13;10;23
10;14;44;13;13;26
10;28;41;13;7;20
10;28;39;13;6;19
10;56;25;13;18;31
10;28;25;13;5;18
10;28;11;13;24;37
10;28;5;13;12;25
10;28;0;13;16;29
10;35;90;12;17;29
10;105;87;12;13;25
10;21;82;12;24;36
10;7;80;12;12;24
10;7;72;12;4;16
10;14;65;12;9;21
10;14;57;12;16;28
10;28;42;12;10;22
10;28;37;12;9;21
10;28;35;12;5;17
10;28;30;12;10;22
10;14;27;12;16;28
10;28;21;12;3;15
10;28;19;12;9;21
10;91;89;11;14;25
10;112;86;11;27;38
10;70;84;11;23;34
10;21;84;11;28;39
10;112;83;11;23;34
10;63;81;11;19;30
10;7;79;11;12;23
10;63;72;11;31;42
10;14;72;11;4;15
10;56;69;11;11;22
10;56;54;11;19;30
10;28;47;11;3;14
10;28;46;11;5;16
10;28;45;11;11;22
10;28;4;11;10;21
10;105;88;10;22;32
10;70;88;10;10;20
10;21;87;10;11;21
10;91;86;10;15;25
10;42;86;10;10;20
10;21;86;10;19;29
10;35;85;10;24;34
10;112;84;10;16;26
10;84;83;10;10;20
10;70;82;10;19;29
10;7;82;10;13;23
10;7;81;10;8;18
10;63;79;10;20;30
10;7;76;10;6;16
10;14;73;10;10;20
10;77;68;10;8;18
10;14;67;10;14;24
10;7;67;10;15;25
10;28;52;10;2;12
10;28;24;10;7;17
10;28;17;10;8;18
10;49;101;9;0;9
10;49;93;9;23;32
10;105;91;9;9;18
10;49;91;9;38;47
10;21;85;9;23;32
10;63;83;9;11;20
10;84;78;9;17;26
10;77;78;9;9;18
10;77;76;9;14;23
10;77;73;9;9;18
10;7;73;9;15;24
10;77;70;9;12;21
10;14;68;9;10;19
10;14;64;9;9;18
10;14;63;9;9;18
10;28;54;9;7;16
10;28;43;9;5;14
10;28;40;9;9;18
10;28;20;9;8;17
10;49;92;8;51;59
10;35;91;8;17;25
10;35;89;8;17;25
10;21;89;8;8;16
10;98;87;8;4;12
10;105;85;8;25;33
10;63;85;8;14;22
10;70;83;8;22;30
10;98;81;8;12;20
10;56;77;8;8;16
10;77;72;8;11;19
10;56;66;8;15;23
10;28;60;8;3;11
10;105;90;7;20;27
10;21;88;7;14;21
10;42;87;7;10;17
10;35;87;7;25;32
10;98;85;7;9;16
10;98;84;7;21;28
10;98;83;7;6;13
10;14;79;7;4;11
10;56;78;7;5;12
10;7;78;7;8;15
10;77;77;7;6;13
10;56;76;7;3;10
10;56;74;7;13;20
10;28;48;7;6;13
10;91;91;6;11;17
10;105;89;6;16;22
10;112;88;6;14;20
10;63;88;6;4;10
10;112;87;6;11;17
10;7;87;6;1;7
10;98;86;6;3;9
10;56;86;6;0;6
10;7;85;6;3;9
10;77;84;6;6;12
10;56;79;6;5;11
10;56;75;6;9;15
10;28;75;6;1;7
10;56;72;6;7;13
10;28;70;6;3;9
10;14;70;6;10;16
10;14;66;6;13;19
10;28;58;6;9;15
10;28;22;6;8;14
10;105;93;5;6;11
10;35;93;5;9;14
10;91;92;5;9;14
10;21;91;5;7;12
10;98;89;5;3;8
10;42;88;5;10;15
10;84;87;5;4;9
10;70;87;5;14;19
10;84;86;5;5;10
10;35;86;5;17;22
10;84;85;5;10;15
10;70;85;5;15;20
10;42;85;5;14;19
10;63;84;5;6;11
10;56;84;5;2;7
10;42;84;5;14;19
10;77;83;5;4;9
10;7;83;5;5;10
10;77;80;5;6;11
10;14;75;5;6;11
10;28;38;5;5;10
10;112;92;4;3;7
10;35;92;4;7;11
10;21;92;4;2;6
10;98;90;4;4;8
10;63;90;4;4;8
10;77;89;4;4;8
10;70;89;4;8;12
10;42;89;4;7;11
10;14;89;4;0;4
10;7;89;4;7;11
10;84;88;4;7;11
10;77;88;4;0;4
10;35;88;4;24;28
10;91;87;4;27;31
10;63;87;4;12;16
10;14;87;4;4;8
10;77;86;4;4;8
10;63;86;4;5;9
10;84;84;4;16;20
10;77;81;4;4;8
10;56;80;4;8;12
10;14;80;4;2;6
10;14;77;4;7;11
10;7;75;4;16;20
10;14;74;4;10;14
10;28;67;4;4;8
10;28;66;4;1;5
10;28;61;4;3;7
10;28;51;4;7;11
10;28;49;4;3;7
10;28;18;4;10;14
10;91;95;3;2;5
10;105;94;3;2;5
10;91;94;3;6;9
10;84;94;3;3;6
10;77;94;3;1;4
10;21;93;3;1;4
10;84;91;3;8;11
10;42;91;3;5;8
10;56;90;3;0;3
10;42;90;3;7;10
10;21;90;3;11;14
10;84;89;3;7;10
10;77;85;3;4;7
10;14;83;3;5;8
10;14;82;3;2;5
10;28;81;3;3;6
10;28;80;3;1;4
10;14;78;3;8;11
10;28;73;3;2;5
10;14;71;3;13;16
10;28;68;3;5;8
10;28;65;3;8;11
10;28;59;3;8;11
10;28;57;3;4;7
10;28;56;3;7;10
10;28;53;3;4;7
10;35;110;2;0;2
10;49;98;2;0;2
10;112;97;2;0;2
10;112;95;2;6;8
10;63;95;2;2;4
10;42;95;2;1;3
10;35;95;2;3;5
10;98;94;2;0;2
10;35;94;2;6;8
10;14;94;2;0;2
10;70;92;2;4;6
10;42;92;2;0;2
10;112;91;2;10;12
10;77;91;2;2;4
10;63;91;2;2;4
10;28;91;2;2;4
10;112;90;2;8;10
10;7;90;2;3;5
10;63;89;2;8;10
10;56;89;2;2;4
10;98;88;2;6;8
10;56;88;2;4;6
10;70;86;2;13;15
10;7;86;2;8;10
10;7;84;2;5;7
10;56;83;2;8;10
10;77;82;2;4;6
10;56;82;2;7;9
10;14;81;2;2;4
10;77;79;2;9;11
10;14;76;2;5;7
10;28;72;2;6;8
10;28;69;2;3;5
10;28;64;2;5;7
10;28;63;2;5;7
10;42;110;1;0;1
10;42;109;1;0;1
10;105;104;1;0;1
10;105;102;1;0;1
10;42;102;1;0;1
10;35;102;1;0;1
10;35;100;1;1;2
10;105;99;1;0;1
10;91;99;1;3;4
10;84;99;1;0;1
10;77;99;1;0;1
10;70;99;1;1;2
10;63;99;1;1;2
10;112;98;1;1;2
10;91;98;1;1;2
10;35;98;1;2;3
10;91;97;1;2;3
10;56;97;1;0;1
10;35;97;1;1;2
10;98;96;1;0;1
10;84;96;1;0;1
10;7;96;1;1;2
10;105;95;1;6;7
10;77;95;1;0;1
10;70;95;1;1;2
10;56;95;1;0;1
10;7;95;1;0;1
10;112;94;1;3;4
10;70;94;1;3;4
10;63;94;1;1;2
10;49;94;1;53;54
10;42;94;1;2;3
10;21;94;1;2;3
10;7;94;1;0;1
10;91;93;1;6;7
10;84;93;1;2;3
10;70;93;1;1;2
10;42;93;1;2;3
10;28;93;1;0;1
10;14;93;1;1;2
10;98;92;1;4;5
10;56;92;1;2;3
10;28;92;1;0;1
10;14;92;1;0;1
10;7;92;1;1;2
10;98;91;1;3;4
10;70;91;1;2;3
10;56;91;1;3;4
10;14;91;1;1;2
10;7;91;1;4;5
10;84;90;1;4;5
10;28;90;1;1;2
10;112;89;1;12;13
10;7;88;1;3;4
10;56;87;1;5;6
10;28;87;1;0;1
10;56;85;1;4;5
10;14;85;1;3;4
10;28;84;1;1;2
10;14;84;1;7;8
10;56;81;1;8;9
10;28;79;1;2;3
10;28;77;1;2;3
10;28;76;1;4;5
10;28;71;1;2;3
10;28;62;1;2;3
10;28;55;1;3;4
10;105;110;0;1;1
10;49;110;0;1;1
10;49;107;0;7;7
10;105;105;0;1;1
10;49;103;0;1;1
10;35;103;0;1;1
10;91;101;0;1;1
10;105;100;0;1;1
10;91;100;0;1;1
10;84;100;0;1;1
10;70;100;0;1;1
10;49;100;0;10;10
10;98;99;0;1;1
10;35;99;0;1;1
10;21;99;0;1;1
10;105;98;0;2;2
10;98;98;0;1;1
10;70;98;0;1;1
10;63;98;0;2;2
10;21;98;0;1;1
10;105;97;0;3;3
10;84;97;0;1;1
10;77;97;0;1;1
10;63;97;0;1;1
10;49;97;0;11;11
10;112;96;0;3;3
10;105;96;0;2;2
10;91;96;0;7;7
10;77;96;0;1;1
10;63;96;0;1;1
10;49;96;0;1;1
10;35;96;0;3;3
10;21;96;0;4;4
10;14;96;0;1;1
10;98;95;0;3;3
10;84;95;0;3;3
10;21;95;0;2;2
10;56;94;0;2;2
10;112;93;0;7;7
10;98;93;0;4;4
10;63;93;0;1;1
10;56;93;0;1;1
10;84;92;0;1;1
10;77;92;0;3;3
10;63;92;0;4;4
10;70;90;0;6;6
10;14;90;0;2;2
10;28;89;0;1;1
10;14;88;0;3;3
10;77;87;0;5;5
10;28;86;0;1;1
10;14;86;0;5;5
10;28;85;0;2;2
10;28;83;0;1;1
10;28;82;0;2;2
10;28;78;0;1;1
10;28;74;0;1;1
14;14;19;13046;12831;25877
14;14;20;12595;13170;25765
14;14;24;12384;12765;25149
14;14;23;12338;12822;25160
14;14;28;12299;11979;24278
14;14;22;11981;12502;24483
14;14;21;11980;12248;24228
14;14;18;11890;12581;24471
14;14;25;11697;12193;23890
14;14;31;11577;11607;23184
14;14;30;11523;12691;24214
14;14;0;11306;10304;21610
14;14;29;11260;12013;23273
14;14;27;11256;11806;23062
14;14;16;11130;10569;21699
14;14;15;10883;10341;21224
14;14;10;10853;10666;21519
14;14;17;10845;10376;21221
14;14;6;10786;10020;20806
14;14;1;10768;10366;21134
14;14;14;10676;10730;21406
14;14;32;10649;11092;21741
14;14;7;10636;10981;21617
14;14;2;10629;10876;21505
14;14;11;10476;10836;21312
14;14;26;10464;11172;21636
14;14;33;10432;11276;21708
14;14;3;10298;10063;20361
14;14;9;10226;9833;20059
14;14;5;10211;9833;20044
14;14;12;10088;10716;20804
14;14;4;10003;9614;19617
14;14;13;9942;9797;19739
14;14;8;9890;10080;19970
14;14;34;9199;9801;19000
14;14;35;9073;10232;19305
14;14;38;8521;9006;17527
14;14;37;8480;8800;17280
14;14;36;8454;8978;17432
14;14;40;8291;8365;16656
14;14;39;8149;8414;16563
14;14;41;7154;7622;14776
14;14;50;7121;7497;14618
14;14;47;7096;7056;14152
14;14;46;7059;7699;14758
14;14;49;7003;7632;14635
14;14;42;6949;7444;14393
14;14;43;6704;7138;13842
14;14;48;6453;7505;13958
14;14;45;6436;7897;14333
14;14;44;6408;6601;13009
14;14;54;5946;6939;12885
14;14;53;5862;6923;12785
14;14;51;5759;6618;12377
14;14;55;5740;6625;12365
14;14;52;5542;6895;12437
14;14;58;5523;6683;12206
14;14;60;5501;7080;12581
14;14;56;5469;6822;12291
14;14;59;5238;6444;11682
14;14;57;5073;6933;12006
14;14;62;5001;5953;10954
14;14;63;4821;5765;10586
14;14;61;4791;6042;10833
14;14;64;4763;5875;10638
14;14;65;4411;5679;10090
14;14;68;3827;4574;8401
14;14;66;3761;5296;9057
14;14;67;3584;4702;8286
14;14;70;3234;4783;8017
14;14;69;3123;4448;7571
14;14;71;2832;3830;6662
14;14;72;2784;3852;6636
14;14;74;2635;3818;6453
14;14;73;2313;3731;6044
14;98;18;2249;1812;4061
14;21;6;2193;2081;4274
14;21;0;2186;1949;4135
14;21;14;2172;2166;4338
14;21;5;2170;2054;4224
14;21;11;2168;2154;4322
14;14;75;2154;3720;5874
14;21;2;2149;2183;4332
14;21;16;2146;1937;4083
14;21;7;2145;2116;4261
14;98;19;2139;2146;4285
14;21;4;2137;2024;4161
14;21;10;2117;2142;4259
14;98;20;2109;2104;4213
14;21;3;2102;1921;4023
14;98;17;2097;2046;4143
14;21;8;2093;2031;4124
14;21;9;2092;2085;4177
14;98;11;2085;1903;3988
14;21;12;2071;2081;4152
14;98;15;2059;1765;3824
14;21;18;2057;1980;4037
14;21;1;2036;2078;4114
14;98;13;2035;1927;3962
14;21;17;2024;1956;3980
14;21;13;2015;1949;3964
14;98;25;2012;1726;3738
14;21;15;2012;2056;4068
14;98;12;2006;1981;3987
14;98;16;2004;1759;3763
14;98;0;2004;1838;3842
14;98;14;1974;2109;4083
14;98;32;1966;1872;3838
14;98;2;1961;1840;3801
14;98;27;1959;1819;3778
14;14;77;1957;3098;5055
14;98;4;1951;1827;3778
14;14;76;1949;3498;5447
14;14;79;1941;3118;5059
14;98;29;1940;1922;3862
14;21;19;1934;1956;3890
14;98;7;1927;1863;3790
14;98;28;1924;1860;3784
14;98;24;1922;2087;4009
14;98;3;1920;1742;3662
14;98;9;1917;1934;3851
14;98;21;1909;2009;3918
14;98;23;1902;2191;4093
14;140;17;1902;1629;3531
14;98;31;1895;1731;3626
14;14;78;1881;3348;5229
14;21;24;1881;1747;3628
14;98;10;1877;1830;3707
14;140;14;1858;1766;3624
14;21;20;1856;1882;3738
14;14;80;1849;3302;5151
14;98;26;1845;1902;3747
14;98;6;1837;1761;3598
14;98;33;1828;1830;3658
14;98;5;1806;1847;3653
14;140;2;1806;1831;3637
14;21;25;1802;1640;3442
14;21;30;1799;1931;3730
14;21;28;1788;1798;3586
14;140;16;1781;1617;3398
14;140;12;1769;1570;3339
14;140;9;1762;1739;3501
14;140;7;1755;1657;3412
14;21;29;1743;1762;3505
14;21;26;1743;1732;3475
14;21;23;1740;1791;3531
14;98;1;1738;1993;3731
14;140;19;1736;1551;3287
14;140;4;1731;1723;3454
14;21;21;1727;1702;3429
14;140;6;1727;1568;3295
14;140;15;1725;1691;3416
14;140;10;1725;1713;3438
14;21;22;1716;1753;3469
14;98;30;1708;2207;3915
14;21;27;1706;1663;3369
14;140;3;1687;1436;3123
14;98;8;1684;1681;3365
14;98;22;1682;2057;3739
14;98;35;1680;1679;3359
14;21;35;1675;1757;3432
14;91;12;1663;1647;3310
14;140;20;1659;1570;3229
14;21;32;1656;1875;3531
14;140;5;1655;1749;3404
14;140;32;1654;1521;3175
14;21;31;1654;1854;3508
14;91;17;1652;1800;3452
14;21;33;1647;1742;3389
14;140;13;1638;1599;3237
14;140;11;1635;1627;3262
14;140;18;1633;1684;3317
14;140;28;1627;1632;3259
14;140;29;1626;1558;3184
14;91;14;1618;1525;3143
14;91;18;1609;1668;3277
14;21;38;1604;1653;3257
14;21;37;1597;1651;3248
14;140;27;1587;1406;2993
14;21;36;1572;1714;3286
14;21;34;1571;1789;3360
14;140;30;1571;1586;3157
14;140;8;1569;1600;3169
14;140;1;1568;1527;3095
14;140;0;1566;1574;3140
14;21;40;1565;1599;3164
14;98;40;1563;1498;3061
14;98;39;1563;1473;3036
14;98;36;1551;1646;3197
14;98;37;1547;1470;3017
14;140;21;1544;1488;3032
14;21;39;1543;1563;3106
14;140;25;1524;1571;3095
14;98;55;1523;1341;2864
14;140;34;1522;1377;2899
14;91;11;1520;1481;3001
14;91;7;1517;1458;2975
14;98;34;1512;1843;3355
14;140;24;1509;1532;3041
14;91;9;1507;1485;2992
14;91;10;1506;1383;2889
14;140;22;1502;1467;2969
14;98;38;1498;1376;2874
14;98;47;1480;1427;2907
14;98;45;1479;1661;3140
14;98;44;1467;1401;2868
14;91;6;1466;1346;2812
14;140;23;1433;1406;2839
14;91;13;1425;1500;2925
14;91;16;1424;1507;2931
14;21;41;1418;1457;2875
14;140;31;1417;1572;2989
14;140;26;1417;1360;2777
14;140;37;1414;1425;2839
14;140;39;1411;1211;2622
14;21;42;1407;1400;2807
14;98;49;1399;1376;2775
14;98;48;1399;1413;2812
14;91;20;1398;1351;2749
14;91;8;1398;1158;2556
14;91;15;1396;1616;3012
14;98;46;1393;1574;2967
14;91;19;1390;1436;2826
14;98;56;1378;1335;2713
14;140;33;1370;1474;2844
14;91;22;1370;1187;2557
14;98;42;1361;1527;2888
14;140;40;1356;1253;2609
14;98;41;1350;1548;2898
14;14;81;1341;2604;3945
14;91;0;1336;1324;2660
14;91;29;1318;1234;2552
14;14;82;1316;2359;3675
14;140;35;1303;1380;2683
14;140;45;1300;1180;2480
14;91;1;1293;1293;2586
14;140;48;1288;1092;2380
14;140;36;1272;1266;2538
14;91;2;1272;1176;2448
14;98;43;1260;1579;2839
14;21;43;1258;1331;2589
14;91;5;1256;1308;2564
14;91;21;1253;1321;2574
14;98;51;1248;1195;2443
14;21;45;1247;1264;2511
14;91;4;1246;1310;2556
14;140;41;1244;1211;2455
14;140;50;1240;1321;2561
14;91;28;1238;1108;2346
14;98;60;1228;1276;2504
14;91;23;1227;1155;2382
14;91;31;1222;1300;2522
14;98;50;1221;1382;2603
14;91;3;1216;1257;2473
14;42;14;1209;1129;2338
14;21;44;1207;1299;2506
14;98;58;1199;1241;2440
14;91;30;1198;1369;2567
14;98;57;1194;1324;2518
14;21;47;1193;1285;2478
14;21;46;1189;1257;2446
14;91;38;1188;1095;2283
14;91;33;1176;1236;2412
14;21;48;1174;1168;2342
14;91;32;1173;1331;2504
14;91;35;1171;1189;2360
14;42;31;1171;1085;2256
14;91;37;1167;1148;2315
14;14;83;1166;2165;3331
14;42;4;1165;884;2049
14;42;6;1153;931;2084
14;98;53;1148;1474;2622
14;91;40;1147;1115;2262
14;140;43;1146;1210;2356
14;91;26;1146;1261;2407
14;140;46;1145;1149;2294
14;91;25;1144;1112;2256
14;42;20;1139;1094;2233
14;42;7;1137;815;1952
14;42;19;1135;1117;2252
14;140;51;1133;1051;2184
14;21;50;1132;1173;2305
14;140;38;1131;1283;2414
14;91;34;1131;1313;2444
14;42;9;1130;994;2124
14;98;52;1123;1291;2414
14;91;27;1122;1117;2239
14;21;49;1121;1214;2335
14;140;42;1115;1184;2299
14;42;2;1114;962;2076
14;98;54;1108;1442;2550
14;42;27;1103;920;2023
14;42;18;1101;951;2052
14;140;47;1093;1259;2352
14;140;44;1091;1237;2328
14;140;53;1083;1112;2195
14;42;15;1083;968;2051
14;140;49;1077;1181;2258
14;42;11;1077;1014;2091
14;91;47;1072;1307;2379
14;42;26;1070;1158;2228
14;98;59;1069;1229;2298
14;42;30;1069;959;2028
14;42;16;1069;876;1945
14;42;13;1067;1112;2179
14;42;0;1062;890;1952
14;140;59;1055;1118;2173
14;42;25;1053;984;2037
14;98;62;1050;1141;2191
14;21;51;1046;1083;2129
14;91;46;1043;1040;2083
14;42;23;1041;1013;2054
14;98;64;1032;1139;2171
14;98;61;1032;1207;2239
14;140;55;1030;1039;2069
14;91;49;1030;1007;2037
14;42;29;1029;1064;2093
14;42;22;1027;1022;2049
14;140;52;1025;986;2011
14;91;24;1023;1174;2197
14;98;65;1022;1098;2120
14;42;8;1019;843;1862
14;140;57;1017;983;2000
14;42;10;1017;763;1780
14;91;36;1015;1166;2181
14;140;54;1012;953;1965
14;91;39;1012;1381;2393
14;21;53;1010;1036;2046
14;42;17;1010;1044;2054
14;42;5;1010;1020;2030
14;140;58;1008;961;1969
14;21;52;1007;1036;2043
14;91;50;1006;1033;2039
14;119;14;1002;963;1965
14;140;61;1000;948;1948
14;98;63;993;1154;2147
14;42;24;993;913;1906
14;91;48;989;1017;2006
14;42;1;989;1207;2196
14;91;45;987;1072;2059
14;42;12;987;1024;2011
14;91;42;981;1031;2012
14;140;56;974;1033;2007
14;91;59;973;986;1959
14;140;60;972;1220;2192
14;21;54;968;1083;2051
14;147;20;968;801;1769
14;91;52;964;950;1914
14;91;41;962;1095;2057
14;119;15;960;935;1895
14;161;14;958;917;1875
14;161;13;946;890;1836
14;42;33;943;929;1872
14;91;54;940;1031;1971
14;91;43;939;1042;1981
14;147;18;939;805;1744
14;119;10;939;890;1829
14;147;19;938;874;1812
14;42;28;935;1166;2101
14;161;15;935;901;1836
14;147;15;935;830;1765
14;91;44;934;1099;2033
14;42;35;934;868;1802
14;182;18;930;822;1752
14;140;62;926;1031;1957
14;21;60;924;959;1883
14;21;55;924;1028;1952
14;182;13;924;883;1807
14;161;9;924;866;1790
14;91;56;922;1027;1949
14;42;3;920;1034;1954
14;119;16;917;877;1794
14;161;10;916;935;1851
14;42;21;915;896;1811
14;63;14;914;823;1737
14;147;12;912;859;1771
14;91;60;911;1103;2014
14;147;16;909;822;1731
14;119;18;907;889;1796
14;182;19;906;827;1733
14;119;12;906;855;1761
14;91;51;905;1049;1954
14;21;56;904;1026;1930
14;161;16;904;898;1802
14;98;68;901;999;1900
14;182;12;901;822;1723
14;91;55;900;1052;1952
14;147;6;900;818;1718
14;147;14;894;915;1809
14;91;57;893;999;1892
14;91;58;891;951;1842
14;161;7;891;839;1730
14;182;17;890;820;1710
14;182;14;890;883;1773
14;161;11;890;855;1745
14;182;16;883;862;1745
14;119;13;883;881;1764
14;182;7;883;881;1764
14;42;32;881;1195;2076
14;147;23;880;736;1616
14;147;7;879;875;1754
14;161;8;878;824;1702
14;147;10;876;823;1699
14;91;53;873;1065;1938
14;119;19;873;904;1777
14;161;6;873;830;1703
14;161;5;873;813;1686
14;21;58;872;984;1856
14;147;8;869;827;1696
14;140;63;868;1020;1888
14;147;9;868;870;1738
14;21;57;866;992;1858
14;182;15;866;810;1676
14;63;15;865;793;1658
14;147;11;865;913;1778
14;161;18;863;842;1705
14;161;12;863;881;1744
14;182;8;861;831;1692
14;119;8;861;821;1682
14;98;69;860;1018;1878
14;119;5;860;854;1714
14;119;11;859;943;1802
14;161;1;859;760;1619
14;182;10;858;848;1706
14;119;20;855;863;1718
14;119;2;855;782;1637
14;119;9;854;873;1727
14;182;11;853;860;1713
14;182;9;853;801;1654
14;147;5;852;829;1681
14;63;16;850;827;1677
14;119;6;849;775;1624
14;147;22;847;707;1554
14;182;0;846;793;1639
14;182;20;845;810;1655
14;161;17;845;889;1734
14;147;17;845;820;1665
14;14;84;844;2053;2897
14;63;20;844;757;1601
14;21;59;843;963;1806
14;161;20;842;817;1659
14;63;17;842;813;1655
14;119;22;840;791;1631
14;63;13;839;753;1592
14;161;2;839;846;1685
14;161;4;838;770;1608
14;147;24;835;754;1589
14;147;21;835;738;1573
14;147;4;827;750;1577
14;147;25;826;677;1503
14;119;17;825;908;1733
14;42;36;824;766;1590
14;98;70;823;968;1791
14;182;31;823;764;1587
14;161;19;823;877;1700
14;91;62;822;866;1688
14;119;7;819;810;1629
14;147;30;818;779;1597
14;63;18;817;722;1539
14;147;13;817;850;1667
14;42;34;816;701;1517
14;182;6;816;856;1672
14;119;1;816;789;1605
14;147;2;815;787;1602
14;63;30;814;794;1608
14;147;3;813;790;1603
14;161;0;813;767;1580
14;63;29;812;782;1594
14;119;21;811;787;1598
14;161;3;809;716;1525
14;147;33;808;758;1566
14;63;19;807;814;1621
14;98;66;806;1135;1941
14;63;12;804;809;1613
14;182;1;803;760;1563
14;147;1;803;793;1596
14;63;8;802;687;1489
14;147;29;801;787;1588
14;63;31;800;721;1521
14;119;31;799;823;1622
14;161;30;797;808;1605
14;161;22;797;728;1525
14;63;6;797;758;1555
14;119;0;797;719;1516
14;182;3;794;796;1590
14;182;5;793;839;1632
14;119;4;793;827;1620
14;63;10;792;740;1532
14;182;4;792;766;1558
14;42;41;791;744;1535
14;147;31;791;773;1564
14;63;0;790;705;1495
14;63;11;789;795;1584
14;119;32;788;771;1559
14;161;28;788;779;1567
14;119;26;788;752;1540
14;147;26;786;684;1470
14;119;24;786;811;1597
14;42;50;785;779;1564
14;42;37;785;927;1712
14;119;3;785;726;1511
14;98;71;784;975;1759
14;21;61;783;926;1709
14;63;9;783;706;1489
14;14;85;782;1903;2685
14;182;30;782;812;1594
14;147;28;782;784;1566
14;119;23;782;762;1544
14;42;53;780;703;1483
14;182;28;780;788;1568
14;119;29;779;792;1571
14;182;25;779;738;1517
14;91;65;775;969;1744
14;161;32;775;742;1517
14;147;0;774;807;1581
14;161;29;773;784;1557
14;42;47;772;791;1563
14;42;40;771;657;1428
14;63;25;771;718;1489
14;161;24;771;771;1542
14;182;26;769;687;1456
14;63;32;768;715;1483
14;63;4;768;737;1505
14;91;61;767;942;1709
14;147;32;767;743;1510
14;182;23;767;695;1462
14;182;29;763;796;1559
14;161;21;763;776;1539
14;147;34;761;660;1421
14;161;33;760;745;1505
14;119;30;759;809;1568
14;182;2;759;809;1568
14;63;21;758;716;1474
14;161;25;755;767;1522
14;182;24;755;731;1486
14;161;23;754;737;1491
14;140;65;753;1035;1788
14;161;27;752;771;1523
14;42;42;751;818;1569
14;182;32;751;748;1499
14;63;28;750;727;1477
14;147;27;749;685;1434
14;182;22;748;721;1469
14;63;2;747;724;1471
14;98;67;744;1111;1855
14;91;64;743;1041;1784
14;182;33;742;754;1496
14;182;27;742;736;1478
14;42;39;741;713;1454
14;63;24;741;724;1465
14;182;21;741;722;1463
14;182;34;739;760;1499
14;63;7;736;725;1461
14;140;64;732;958;1690
14;63;33;732;779;1511
14;119;25;732;772;1504
14;161;31;730;807;1537
14;119;27;729;773;1502
14;140;70;726;838;1564
14;21;62;725;853;1578
14;42;38;724;764;1488
14;119;28;724;815;1539
14;147;35;723;718;1441
14;42;49;721;823;1544
14;42;45;720;684;1404
14;63;22;718;682;1400
14;21;63;717;825;1542
14;119;34;714;721;1435
14;63;26;713;705;1418
14;91;63;711;1012;1723
14;182;36;711;661;1372
14;140;69;710;677;1387
14;63;5;710;678;1388
14;161;34;708;770;1478
14;161;26;707;755;1462
14;182;37;705;646;1351
14;63;27;704;705;1409
14;119;33;701;765;1466
14;140;66;700;850;1550
14;119;36;699;683;1382
14;42;51;692;751;1443
14;161;38;692;687;1379
14;14;86;691;1580;2271
14;63;3;691;679;1370
14;63;1;690;690;1380
14;42;56;689;580;1269
14;91;67;688;853;1541
14;21;65;688;779;1467
14;140;67;687;847;1534
14;91;66;687;896;1583
14;119;35;687;734;1421
14;63;23;687;688;1375
14;119;37;685;671;1356
14;161;35;683;674;1357
14;42;52;682;678;1360
14;119;40;677;619;1296
14;63;34;677;721;1398
14;147;38;674;629;1303
14;42;48;672;744;1416
14;28;16;672;630;1302
14;140;68;671;901;1572
14;63;35;670;730;1400
14;147;36;668;645;1313
14;42;46;666;759;1425
14;182;35;666;693;1359
14;182;47;663;608;1271
14;42;55;661;720;1381
14;63;49;660;668;1328
14;147;39;657;649;1306
14;161;37;656;696;1352
14;161;36;656;711;1367
14;28;15;652;626;1278
14;119;38;649;654;1303
14;21;64;648;813;1461
14;119;39;647;635;1282
14;161;39;646;707;1353
14;147;37;643;711;1354
14;161;46;641;719;1360
14;161;48;640;664;1304
14;182;39;639;584;1223
14;28;17;639;587;1226
14;119;47;637;600;1237
14;63;45;637;577;1214
14;28;14;637;582;1219
14;63;46;635;646;1281
14;182;45;635;604;1239
14;42;57;634;603;1237
14;147;40;633;586;1219
14;182;41;631;564;1195
14;161;53;630;589;1219
14;161;50;630;667;1297
14;98;72;629;840;1469
14;63;38;628;648;1276
14;182;40;626;609;1235
14;63;37;626;663;1289
14;21;67;625;670;1295
14;182;46;625;624;1249
14;182;38;625;658;1283
14;63;36;625;663;1288
14;63;40;624;668;1292
14;182;54;623;572;1195
14;161;54;623;656;1279
14;63;47;623;633;1256
14;91;68;621;805;1426
14;28;13;621;634;1255
14;161;44;620;623;1243
14;161;42;620;667;1287
14;182;49;617;602;1219
14;63;39;617;606;1223
14;21;66;616;706;1322
14;63;48;616;618;1234
14;161;41;615;661;1276
14;161;47;612;694;1306
14;161;40;612;696;1308
14;98;74;611;781;1392
14;182;53;610;597;1207
14;63;50;608;580;1188
14;182;50;606;629;1235
14;119;46;606;646;1252
14;147;42;605;534;1139
14;119;41;605;609;1214
14;161;52;603;631;1234
14;161;56;602;578;1180
14;119;45;601;650;1251
14;182;60;600;601;1201
14;42;58;600;551;1151
14;161;43;600;599;1199
14;63;57;597;630;1227
14;28;12;597;557;1154
14;91;69;596;949;1545
14;161;51;596;630;1226
14;63;53;592;575;1167
14;28;18;592;580;1172
14;63;60;590;594;1184
14;147;41;590;561;1151
14;63;56;589;581;1170
14;28;11;589;596;1185
14;42;54;588;738;1326
14;161;45;588;675;1263
14;182;44;588;573;1161
14;63;41;588;585;1173
14;119;48;587;686;1273
14;161;59;586;600;1186
14;161;49;586;684;1270
14;63;52;583;611;1194
14;28;10;583;556;1139
14;147;46;582;545;1127
14;119;43;582;539;1121
14;63;54;580;607;1187
14;63;55;574;609;1183
14;63;43;574;532;1106
14;42;65;568;519;1087
14;182;58;568;528;1096
14;161;55;565;628;1193
14;182;52;565;548;1113
14;182;43;565;573;1138
14;63;42;565;620;1185
14;119;42;564;628;1192
14;7;10;564;548;1112
14;28;9;564;542;1106
14;63;58;563;559;1122
14;182;48;563;586;1149
14;56;17;563;473;1036
14;140;75;561;644;1205
14;182;57;560;524;1084
14;56;11;560;486;1046
14;161;58;559;609;1168
14;182;42;559;588;1147
14;182;51;556;574;1130
14;21;68;555;597;1152
14;63;44;554;573;1127
14;98;76;550;611;1161
14;140;72;550;688;1238
14;161;60;550;643;1193
14;182;56;550;555;1105
14;119;52;550;543;1093
14;63;51;550;587;1137
14;7;11;550;491;1041
14;147;48;548;509;1057
14;91;70;547;782;1329
14;161;57;545;564;1109
14;56;8;545;515;1060
14;56;15;544;506;1050
14;119;49;543;603;1146
14;42;43;543;749;1292
14;119;50;542;615;1157
14;21;69;540;643;1183
14;182;55;540;584;1124
14;14;87;537;1342;1879
14;161;61;537;647;1184
14;42;59;536;572;1108
14;182;62;535;516;1051
14;147;45;533;559;1092
14;133;14;533;572;1105
14;63;65;532;556;1088
14;119;44;532;602;1134
14;28;6;531;490;1021
14;56;10;530;514;1044
14;7;12;529;474;1003
14;28;5;529;507;1036
14;119;53;528;558;1086
14;133;18;528;475;1003
14;56;13;527;526;1053
14;147;47;526;547;1073
14;133;9;526;499;1025
14;56;9;526;472;998
14;56;2;526;463;989
14;98;75;525;869;1394
14;119;58;525;458;983
14;56;14;525;509;1034
14;133;10;525;504;1029
14;119;54;523;539;1062
14;147;50;522;548;1070
14;133;8;522;499;1021
14;56;7;522;526;1048
14;56;4;522;500;1022
14;56;16;521;528;1049
14;42;44;519;654;1173
14;21;70;518;656;1174
14;63;59;518;535;1053
14;56;19;518;474;992
14;56;6;518;492;1010
14;56;5;518;455;973
14;140;71;517;684;1201
14;28;7;517;558;1075
14;91;71;516;667;1183
14;182;61;516;502;1018
14;119;51;516;548;1064
14;7;17;516;483;999
14;161;62;514;578;1092
14;56;12;513;496;1009
14;140;74;511;704;1215
14;28;20;509;472;981
14;182;59;508;571;1079
14;42;60;507;709;1216
14;133;15;507;504;1011
14;98;79;505;682;1187
14;147;44;505;548;1053
14;28;0;505;493;998
14;98;73;504;756;1260
14;91;73;504;595;1099
14;133;16;504;492;996
14;161;65;503;556;1059
14;119;55;503;521;1024
14;147;51;503;489;992
14;56;18;503;484;987
14;133;13;503;539;1042
14;7;9;503;443;946
14;119;56;502;507;1009
14;147;53;501;485;986
14;147;49;501;517;1018
14;161;63;500;561;1061
14;147;43;500;528;1028
14;56;31;500;493;993
14;28;19;499;537;1036
14;56;0;499;492;991
14;56;20;498;461;959
14;7;7;498;479;977
14;28;2;497;500;997
14;56;1;497;458;955
14;91;72;496;618;1114
14;7;16;496;477;973
14;56;22;495;437;932
14;140;73;494;683;1177
14;28;8;494;587;1081
14;119;57;493;523;1016
14;63;62;492;531;1023
14;28;1;492;467;959
14;56;30;491;491;982
14;98;77;490;694;1184
14;119;59;490;512;1002
14;140;76;489;522;1011
14;28;30;488;476;964
14;133;11;488;531;1019
14;133;6;487;459;946
14;7;14;486;497;983
14;63;63;484;546;1030
14;63;61;484;564;1048
14;147;52;484;476;960
14;133;7;484;455;939
14;42;63;483;699;1182
14;28;4;483;503;986
14;105;9;482;440;922
14;7;15;481;460;941
14;28;28;478;414;892
14;133;5;476;417;893
14;147;55;475;516;991
14;56;25;475;441;916
14;7;8;475;448;923
14;7;3;472;394;866
14;56;28;470;467;937
14;105;7;469;449;918
14;119;60;468;505;973
14;28;25;468;407;875
14;7;18;468;446;914
14;7;5;467;448;915
14;56;32;466;465;931
14;28;24;466;435;901
14;56;23;465;450;915
14;7;2;464;461;925
14;42;61;463;545;1008
14;56;21;463;440;903
14;133;17;463;500;963
14;28;3;463;490;953
14;21;71;462;504;966
14;133;19;462;478;940
14;28;31;461;446;907
14;98;78;460;577;1037
14;119;61;460;499;959
14;119;62;459;494;953
14;56;29;459;449;908
14;105;15;459;464;923
14;105;10;458;476;934
14;105;11;456;464;920
14;7;4;456;406;862
14;63;64;455;544;999
14;28;22;455;415;870
14;56;27;454;442;896
14;91;74;453;572;1025
14;7;13;453;473;926
14;147;56;452;445;897
14;56;33;452;391;843
14;133;12;452;476;928
14;182;65;451;470;921
14;161;64;451;563;1014
14;7;6;451;443;894
14;56;3;450;473;923
14;105;14;448;494;942
14;147;54;447;485;932
14;126;14;447;410;857
14;105;13;447;468;915
14;105;1;445;421;866
14;42;62;443;539;982
14;182;66;442;446;888
14;182;63;442;494;936
14;147;60;442;440;882
14;105;12;442;453;895
14;105;16;441;453;894
14;105;8;439;399;838
14;7;1;439;403;842
14;56;40;438;405;843
14;63;67;437;483;920
14;42;64;437;607;1044
14;56;24;437;448;885
14;105;18;437;426;863
14;133;20;436;414;850
14;105;17;434;404;838
14;28;26;431;337;768
14;105;19;430;394;824
14;7;33;429;396;825
14;147;57;425;449;874
14;28;23;424;384;808
14;161;66;423;474;897
14;7;19;423;349;772
14;161;68;421;469;890
14;105;6;421;402;823
14;133;3;420;439;859
14;119;65;419;461;880
14;182;64;419;507;926
14;147;59;419;463;882
14;56;26;419;456;875
14;133;4;419;425;844
14;126;10;418;379;797
14;147;58;417;486;903
14;161;67;416;497;913
14;56;35;416;389;805
14;7;20;416;408;824
14;28;21;415;465;880
14;56;38;414;342;756
14;98;80;413;622;1035
14;7;32;413;400;813
14;28;27;413;382;795
14;105;2;412;372;784
14;28;29;411;413;824
14;105;3;411;390;801
14;7;0;411;400;811
14;7;31;410;388;798
14;105;20;410;370;780
14;140;77;409;644;1053
14;91;75;408;608;1016
14;7;29;408;384;792
14;133;31;407;385;792
14;133;2;407;414;821
14;14;88;406;1162;1568
14;147;61;406;425;831
14;105;5;406;423;829
14;133;23;405;382;787
14;91;78;404;494;898
14;182;69;404;405;809
14;147;62;404;410;814
14;7;30;404;441;845
14;126;15;404;363;767
14;105;4;404;400;804
14;119;63;403;483;886
14;133;30;402;392;794
14;42;71;401;507;908
14;28;33;401;414;815
14;63;66;398;531;929
14;56;34;397;398;795
14;119;64;395;431;826
14;56;46;395;360;755
14;56;36;395;398;793
14;133;28;394;393;787
14;133;1;394;443;837
14;7;28;393;414;807
14;28;32;392;426;818
14;21;72;391;519;910
14;7;38;391;335;726
14;63;70;390;436;826
14;56;37;390;375;765
14;182;70;389;477;866
14;56;48;389;355;744
14;56;47;389;375;764
14;56;45;389;387;776
14;42;66;387;414;801
14;21;74;386;496;882
14;7;23;386;342;728
14;105;0;385;406;791
14;91;76;384;520;904
14;63;71;384;443;827
14;119;66;382;384;766
14;126;9;382;355;737
14;147;64;381;358;739
14;133;33;381;419;800
14;21;73;380;508;888
14;63;68;380;450;830
14;133;29;378;404;782
14;161;70;377;427;804
14;133;0;377;396;773
14;147;63;376;397;773
14;7;22;376;325;701
14;133;21;374;375;749
14;126;13;372;385;757
14;7;35;370;411;781
14;7;25;370;327;697
14;126;16;369;374;743
14;56;39;368;386;754
14;126;12;367;359;726
14;105;31;366;362;728
14;182;68;365;421;786
14;42;68;365;389;754
14;42;67;365;445;810
14;91;77;364;562;926
14;7;24;364;334;698
14;126;17;364;363;727
14;140;78;363;600;963
14;7;21;363;332;695
14;105;28;362;374;736
14;14;89;361;996;1357
14;63;69;361;453;814
14;84;14;361;336;697
14;126;7;361;355;716
14;105;32;360;341;701
14;133;35;359;329;688
14;56;49;358;378;736
14;28;36;358;350;708
14;84;9;358;296;654
14;133;32;357;413;770
14;133;22;357;382;739
14;182;67;356;438;794
14;56;42;355;365;720
14;7;34;355;385;740
14;126;11;355;376;731
14;28;50;354;349;703
14;7;37;354;361;715
14;133;27;353;361;714
14;7;26;353;338;691
14;56;44;352;346;698
14;133;25;352;360;712
14;105;23;352;383;735
14;35;15;352;296;648
14;161;72;351;426;777
14;42;70;351;520;871
14;133;26;351;358;709
14;126;8;351;344;695
14;91;80;350;527;877
14;133;50;350;278;628
14;28;35;350;340;690
14;161;69;349;431;780
14;105;24;349;359;708
14;105;21;349;347;696
14;49;11;348;288;636
14;56;41;346;333;679
14;28;39;346;347;693
14;105;25;346;345;691
14;105;33;345;319;664
14;7;39;343;299;642
14;28;40;342;348;690
14;105;27;342;358;700
14;126;18;342;362;704
14;56;51;341;317;658
14;56;43;341;342;683
14;105;29;341;359;700
14;7;27;341;375;716
14;140;80;339;528;867
14;182;71;339;404;743
14;133;34;339;347;686
14;63;73;338;426;764
14;56;50;338;314;652
14;28;38;338;319;657
14;105;30;338;372;710
14;84;15;338;293;631
14;21;75;337;536;873
14;133;40;336;325;661
14;133;24;336;373;709
14;42;69;335;497;832
14;126;6;335;304;639
14;7;47;334;325;659
14;84;11;334;291;625
14;119;67;333;392;725
14;7;57;333;293;626
14;49;4;333;300;633
14;35;12;332;285;617
14;147;65;331;370;701
14;126;5;331;321;652
14;147;66;330;360;690
14;105;26;330;312;642
14;126;4;330;288;618
14;28;37;329;342;671
14;84;6;328;325;653
14;28;34;327;366;693
14;56;52;326;328;654
14;133;45;326;339;665
14;126;19;325;322;647
14;119;68;324;405;729
14;28;47;324;301;625
14;7;40;324;357;681
14;105;38;323;279;602
14;133;37;323;362;685
14;133;46;322;324;646
14;49;16;321;285;606
14;35;7;321;308;629
14;119;70;320;395;715
14;56;53;320;310;630
14;133;44;320;341;661
14;7;36;320;334;654
14;105;22;320;337;657
14;84;7;320;311;631
14;133;41;319;311;630
14;133;36;319;354;673
14;105;35;319;336;655
14;35;13;319;290;609
14;84;8;319;281;600
14;49;18;318;281;599
14;35;18;318;307;625
14;56;54;317;317;634
14;35;30;317;286;603
14;140;79;316;696;1012
14;21;78;316;367;683
14;182;72;316;380;696
14;133;38;316;347;663
14;35;11;316;275;591
14;98;81;315;606;921
14;182;73;315;408;723
14;28;53;315;269;584
14;35;14;315;342;657
14;84;10;315;304;619
14;28;41;314;335;649
14;49;13;314;316;630
14;84;12;314;293;607
14;161;71;313;395;708
14;147;67;313;350;663
14;133;42;313;321;634
14;126;2;313;313;626
14;119;69;312;355;667
14;84;13;311;317;628
14;35;2;311;283;594
14;35;10;310;302;612
14;49;15;309;290;599
14;49;14;309;320;629
14;49;10;309;281;590
14;133;39;308;352;660
14;35;8;308;314;622
14;7;60;307;318;625
14;28;46;307;363;670
14;28;42;307;300;607
14;126;0;307;290;597
14;7;52;306;280;586
14;28;49;306;312;618
14;84;1;306;275;581
14;28;48;305;288;593
14;49;17;305;314;619
14;35;9;305;279;584
14;126;1;305;288;593
14;7;46;304;338;642
14;105;34;304;334;638
14;84;17;304;291;595
14;63;75;303;429;732
14;35;27;301;257;558
14;84;16;301;287;588
14;35;16;300;286;586
14;49;8;300;269;569
14;7;45;299;281;580
14;49;7;299;286;585
14;49;1;299;265;564
14;98;82;298;490;788
14;56;56;298;293;591
14;7;42;298;292;590
14;161;74;297;395;692
14;7;61;297;260;557
14;35;20;297;291;588
14;35;4;297;280;577
14;91;79;295;505;800
14;119;73;295;336;631
14;35;29;295;253;548
14;35;17;295;293;588
14;56;55;294;285;579
14;84;28;294;277;571
14;126;20;294;314;608
14;49;2;294;274;568
14;98;83;293;385;678
14;28;52;293;279;572
14;28;43;293;324;617
14;35;28;293;246;539
14;35;6;293;301;594
14;84;3;293;259;552
14;7;56;292;284;576
14;28;45;292;311;603
14;49;12;292;294;586
14;63;72;291;406;697
14;147;69;291;290;581
14;7;59;291;307;598
14;133;57;291;285;576
14;7;50;291;289;580
14;7;41;291;325;616
14;105;36;291;317;608
14;35;1;291;308;599
14;7;44;290;285;575
14;49;6;290;315;605
14;63;74;289;389;678
14;42;72;289;367;656
14;7;53;289;300;589
14;7;49;289;330;619
14;133;48;289;342;631
14;105;45;289;268;557
14;35;25;289;268;557
14;49;5;289;270;559
14;49;3;289;289;578
14;21;76;288;427;715
14;7;55;288;296;584
14;7;51;288;271;559
14;84;5;288;315;603
14;56;60;287;284;571
14;56;59;287;257;544
14;84;29;287;287;574
14;35;5;287;292;579
14;105;37;286;322;608
14;49;19;286;281;567
14;35;3;286;281;567
14;49;9;285;319;604
14;28;54;283;263;546
14;7;48;283;332;615
14;105;39;283;292;575
14;35;31;283;256;539
14;140;82;282;519;801
14;133;47;282;319;601
14;84;20;282;272;554
14;84;18;282;269;551
14;28;51;281;306;587
14;105;46;281;267;548
14;133;43;281;340;621
14;126;22;281;252;533
14;140;81;280;543;823
14;161;75;279;368;647
14;133;52;279;241;520
14;126;3;279;252;531
14;126;30;278;281;559
14;21;77;277;420;697
14;182;75;277;345;622
14;105;41;277;246;523
14;84;31;277;272;549
14;63;76;276;386;662
14;35;22;276;241;517
14;161;73;275;386;661
14;7;43;274;304;578
14;35;21;274;250;524
14;56;57;273;349;622
14;133;51;273;314;587
14;28;44;273;298;571
14;119;71;272;356;628
14;7;62;272;290;562
14;35;19;272;288;560
14;14;90;271;992;1263
14;28;58;271;238;509
14;133;49;271;289;560
14;56;65;270;296;566
14;84;4;270;263;533
14;49;20;269;283;552
14;84;2;269;298;567
14;147;68;268;318;586
14;7;54;267;255;522
14;105;42;267;256;523
14;126;21;267;267;534
14;98;84;266;446;712
14;56;58;265;292;557
14;28;57;265;232;497
14;49;0;265;271;536
14;119;72;264;370;634
14;28;55;264;269;533
14;56;62;263;269;532
14;28;59;263;264;527
14;42;79;262;359;621
14;7;58;262;294;556
14;35;23;262;268;530
14;91;81;261;406;667
14;42;74;261;389;650
14;147;70;261;304;565
14;28;60;261;263;524
14;133;53;261;287;548
14;105;48;261;243;504
14;35;0;261;249;510
14;105;47;260;229;489
14;42;73;259;397;656
14;63;77;258;359;617
14;182;74;258;362;620
14;28;56;258;255;513
14;105;40;258;247;505
14;28;61;257;267;524
14;84;32;257;269;526
14;84;0;257;264;521
14;21;79;256;383;639
14;182;76;256;352;608
14;119;74;256;303;559
14;105;43;256;219;475
14;126;24;255;254;509
14;35;24;255;255;510
14;42;75;254;492;746
14;182;77;253;324;577
14;133;59;253;273;526
14;56;63;252;256;508
14;35;32;252;241;493
14;161;76;251;317;568
14;126;31;251;294;545
14;126;27;251;244;495
14;84;23;251;239;490
14;7;63;250;267;517
14;105;49;249;257;506
14;105;44;248;258;506
14;126;28;248;253;501
14;84;26;248;250;498
14;56;61;247;264;511
14;133;54;247;270;517
14;126;35;247;275;522
14;35;35;247;230;477
14;84;30;247;253;500
14;35;34;246;239;485
14;42;78;245;425;670
14;133;60;245;257;502
14;133;58;245;225;470
14;133;56;245;255;500
14;35;38;244;198;442
14;84;21;244;211;455
14;133;55;243;251;494
14;84;27;243;228;471
14;84;19;243;240;483
14;126;36;242;248;490
14;126;23;242;245;487
14;7;64;241;255;496
14;84;22;241;218;459
14;84;25;240;214;454
14;84;24;240;200;440
14;35;26;238;257;495
14;84;36;237;219;456
14;84;35;237;240;477
14;140;83;236;488;724
14;126;45;236;207;443
14;91;82;235;369;604
14;105;50;235;234;469
14;126;44;235;255;490
14;84;34;235;233;468
14;35;33;235;228;463
14;7;66;234;249;483
14;133;62;234;242;476
14;126;38;234;239;473
14;126;33;234;267;501
14;49;21;233;224;457
14;119;75;231;302;533
14;147;71;230;292;522
14;126;43;229;252;481
14;161;79;228;317;545
14;84;33;228;251;479
14;126;32;228;235;463
14;105;54;227;209;436
14;126;37;227;248;475
14;98;85;226;396;622
14;84;40;226;204;430
14;161;78;225;331;556
14;105;52;224;202;426
14;35;45;224;200;424
14;84;42;224;180;404
14;84;37;224;249;473
14;35;40;223;219;442
14;84;38;223;227;450
14;84;45;222;202;424
14;7;65;221;272;493
14;28;62;221;245;466
14;133;61;221;233;454
14;126;39;221;238;459
14;84;39;221;262;483
14;35;36;221;219;440
14;63;78;220;376;596
14;56;67;220;225;445
14;133;63;219;218;437
14;35;49;219;217;436
14;126;29;219;279;498
14;126;26;219;233;452
14;105;55;218;198;416
14;126;42;218;205;423
14;126;41;218;252;470
14;161;77;217;342;559
14;105;51;217;212;429
14;126;49;216;198;414
14;84;43;216;211;427
14;84;41;216;212;428
14;126;40;216;230;446
14;35;39;216;229;445
14;147;73;215;264;479
14;28;63;215;248;463
14;126;34;215;257;472
14;49;32;215;209;424
14;105;59;214;232;446
14;56;64;213;254;467
14;105;53;213;173;386
14;126;50;213;201;414
14;35;50;212;220;432
14;35;48;212;207;419
14;7;69;211;187;398
14;28;65;211;224;435
14;28;64;211;210;421
14;49;22;211;246;457
14;56;69;210;227;437
14;56;66;210;235;445
14;105;57;210;197;407
14;126;47;210;210;420
14;35;37;210;210;420
14;21;80;208;383;591
14;49;30;208;243;451
14;35;52;207;181;388
14;35;47;207;187;394
14;126;46;207;208;415
14;35;44;207;181;388
14;126;25;207;223;430
14;84;50;206;206;412
14;49;28;206;212;418
14;49;23;206;216;422
14;63;80;205;383;588
14;105;60;205;193;398
14;49;24;205;233;438
14;182;78;204;312;516
14;105;56;204;179;383
14;84;47;204;199;403
14;56;70;203;257;460
14;84;55;203;204;407
14;35;53;203;195;398
14;126;48;203;208;411
14;168;13;203;176;379
14;84;46;202;198;400
14;42;76;201;405;606
14;147;74;201;233;434
14;56;68;201;211;412
14;35;61;201;163;364
14;84;60;201;199;400
14;84;49;201;192;393
14;168;7;201;166;367
14;7;68;200;231;431
14;28;66;200;196;396
14;49;25;200;224;424
14;119;77;199;328;527
14;7;70;199;194;393
14;21;81;198;326;524
14;35;51;197;182;379
14;84;44;197;219;416
14;147;75;196;250;446
14;147;72;196;285;481
14;35;60;196;159;355
14;35;46;196;225;421
14;168;14;196;197;393
14;133;64;195;227;422
14;84;48;195;193;388
14;91;83;194;345;539
14;126;54;194;173;367
14;35;43;194;192;386
14;35;41;194;206;400
14;42;80;192;383;575
14;84;63;192;167;359
14;140;85;190;341;531
14;119;76;190;282;472
14;49;31;190;219;409
14;14;91;189;630;819
14;140;84;189;447;636
14;28;70;189;197;386
14;126;55;189;155;344
14;161;80;188;341;529
14;105;63;188;172;360
14;182;80;187;315;502
14;84;57;187;195;382
14;35;55;187;175;362
14;49;27;187;223;410
14;63;79;186;327;513
14;7;71;186;180;366
14;168;18;186;158;344
14;105;64;185;191;376
14;168;10;185;154;339
14;84;54;184;170;354
14;49;29;184;228;412
14;182;81;183;273;456
14;168;16;183;167;350
14;105;62;182;209;391
14;84;53;182;207;389
14;49;40;182;210;392
14;168;11;182;164;346
14;133;65;181;223;404
14;35;56;181;172;353
14;49;47;181;175;356
14;49;34;181;176;357
14;63;81;180;316;496
14;7;67;180;240;420
14;105;58;180;208;388
14;168;19;180;150;330
14;84;52;179;170;349
14;49;36;179;159;338
14;133;67;178;212;390
14;84;58;178;208;386
14;49;42;178;191;369
14;35;42;178;199;377
14;42;77;177;342;519
14;126;56;177;186;363
14;126;52;177;155;332
14;140;86;176;334;510
14;182;79;176;348;524
14;28;69;176;162;338
14;35;54;176;180;356
14;126;53;176;181;357
14;168;15;176;180;356
14;168;1;176;171;347
14;21;82;175;311;486
14;126;58;175;148;323
14;168;2;175;157;332
14;161;81;174;300;474
14;49;37;173;187;360
14;168;30;173;162;335
14;133;66;172;179;351
14;168;17;172;181;353
14;168;12;172;163;335
14;105;61;171;200;371
14;84;61;171;198;369
14;126;57;171;176;347
14;168;8;171;180;351
14;133;68;170;188;358
14;84;62;170;201;371
14;84;56;170;210;380
14;49;35;170;213;383
14;35;62;169;155;324
14;112;14;169;165;334
14;168;5;169;182;351
14;105;65;168;149;317
14;126;62;168;148;316
14;161;82;167;271;438
14;28;68;167;222;389
14;126;61;167;140;307
14;35;57;167;169;336
14;28;67;166;217;383
14;35;63;165;152;317
14;91;84;164;320;484
14;35;59;164;141;305
14;84;51;164;219;383
14;49;43;164;181;345
14;56;72;163;199;362
14;133;70;162;190;352
14;84;59;162;181;343
14;49;46;162;147;309
14;49;38;162;198;360
14;49;26;162;229;391
14;168;9;162;169;331
14;168;6;162;175;337
14;105;68;161;154;315
14;49;39;161;187;348
14;63;82;160;293;453
14;7;73;160;176;336
14;49;48;160;163;323
14;119;79;159;252;411
14;84;66;159;152;311
14;35;65;159;163;322
14;35;58;159;163;322
14;42;81;158;302;460
14;49;57;158;161;319
14;49;33;158;197;355
14;182;82;157;239;396
14;84;64;157;140;297
14;49;45;157;160;317
14;112;13;157;160;317
14;112;12;157;154;311
14;168;0;157;176;333
14;133;69;156;181;337
14;105;66;156;168;324
14;126;59;156;159;315
14;49;41;156;164;320
14;119;80;155;238;393
14;49;53;155;154;309
14;35;64;154;146;300
14;49;54;154;155;309
14;56;71;153;214;367
14;126;64;153;167;320
14;126;60;153;161;314
14;49;52;153;147;300
14;49;44;153;180;333
14;112;17;153;125;278
14;119;78;151;259;410
14;147;76;151;211;362
14;84;67;151;166;317
14;126;51;151;161;312
14;168;24;150;150;300
14;168;20;150;145;295
14;168;3;150;162;312
14;7;72;149;165;314
14;168;31;149;143;292
14;112;8;149;142;291
14;49;59;148;161;309
14;175;14;148;114;262
14;84;69;147;126;273
14;126;63;147;176;323
14;168;32;147;123;270
14;56;75;146;168;314
14;147;78;145;230;375
14;147;77;145;199;344
14;105;69;145;131;276
14;49;58;145;129;274
14;112;15;145;148;293
14;21;83;144;297;441
14;56;73;144;183;327
14;35;66;144;127;271
14;49;61;144;148;292
14;84;65;143;178;321
14;63;83;142;230;372
14;126;65;142;113;255
14;49;55;142;157;299
14;112;18;142;126;268
14;168;4;142;163;305
14;168;36;141;126;267
14;112;11;141;137;278
14;49;50;140;140;280
14;119;81;139;240;379
14;35;69;139;122;261
14;168;28;139;137;276
14;175;13;139;120;259
14;112;2;139;104;243
14;28;71;138;170;308
14;49;51;138;159;297
14;112;16;138;136;274
14;49;49;137;169;306
14;14;93;136;434;570
14;28;75;136;162;298
14;7;74;136;160;296
14;35;68;135;142;277
14;168;38;135;108;243
14;168;23;135;140;275
14;49;63;134;148;282
14;14;92;133;448;581
14;49;60;133;146;279
14;168;40;133;106;239
14;112;3;133;131;264
14;168;27;132;143;275
14;112;7;132;129;261
14;42;83;131;226;357
14;168;35;131;133;264
14;175;12;131;107;238
14;112;9;131;128;259
14;105;70;130;156;286
14;175;16;130;98;228
14;175;8;130;110;240
14;98;86;129;324;453
14;56;74;129;164;293
14;133;71;129;129;258
14;49;56;129;149;278
14;147;79;128;204;332
14;56;76;128;160;288
14;126;70;128;122;250
14;168;41;128;113;241
14;168;29;128;162;290
14;168;34;127;135;262
14;112;6;127;142;269
14;28;73;126;148;274
14;105;67;126;150;276
14;168;33;126;141;267
14;161;83;125;243;368
14;168;25;125;152;277
14;168;21;125;147;272
14;175;10;125;118;243
14;112;5;125;130;255
14;112;4;125;116;241
14;91;85;124;253;377
14;133;72;124;149;273
14;35;67;124;133;257
14;49;62;124;145;269
14;168;37;123;130;253
14;175;11;123;130;253
14;168;22;122;137;259
14;161;84;121;217;338
14;21;84;121;260;381
14;168;48;121;105;226
14;175;15;121;118;239
14;112;10;121;143;264
14;112;1;121;122;243
14;63;84;120;253;373
14;35;71;120;109;229
14;126;66;120;158;278
14;175;18;120;120;240
14;63;85;119;250;369
14;84;70;119;143;262
14;168;39;119;93;212
14;175;0;119;94;213
14;112;0;119;109;228
14;175;4;118;88;206
14;161;85;117;203;320
14;7;75;117;137;254
14;28;74;117;164;281
14;84;68;117;160;277
14;126;67;117;115;232
14;175;17;117;112;229
14;119;82;116;229;345
14;147;80;116;234;350
14;168;46;116;109;225
14;98;87;115;313;428
14;133;73;115;134;249
14;126;69;115;116;231
14;126;68;115;110;225
14;175;19;115;119;234
14;21;85;114;228;342
14;42;82;114;286;400
14;56;79;114;136;250
14;133;74;114;147;261
14;105;73;114;133;247
14;84;73;114;109;223
14;35;70;114;129;243
14;168;26;114;123;237
14;182;84;113;237;350
14;182;83;113;226;339
14;28;72;113;164;277
14;49;64;112;126;238
14;175;5;112;103;215
14;175;7;111;117;228
14;175;6;111;121;232
14;7;76;110;151;261
14;49;68;110;115;225
14;49;65;110;123;233
14;91;86;109;193;302
14;147;81;109;162;271
14;28;79;109;115;224
14;182;85;108;181;289
14;84;74;108;130;238
14;105;72;107;111;218
14;49;70;107;119;226
14;49;66;107;101;208
14;112;19;107;112;219
14;84;72;106;139;245
14;105;71;106;123;229
14;168;51;106;74;180
14;168;42;106;118;224
14;56;78;105;169;274
14;175;50;105;75;180
14;7;77;104;118;222
14;168;49;103;97;200
14;175;9;103;96;199
14;140;87;101;241;342
14;168;53;101;82;183
14;112;30;101;91;192
14;91;87;100;229;329
14;105;74;100;118;218
14;35;72;100;119;219
14;168;52;100;75;175
14;112;41;100;62;162
14;175;2;100;96;196
14;119;83;99;159;258
14;126;71;99;102;201
14;112;47;99;53;152
14;175;1;99;113;212
14;63;86;98;215;313
14;28;78;98;146;244
14;56;77;98;146;244
14;105;76;98;110;208
14;175;31;98;100;198
14;35;73;97;123;220
14;175;47;97;60;157
14;112;33;97;69;166
14;112;28;97;91;188
14;175;21;97;107;204
14;42;84;96;227;323
14;84;75;96;127;223
14;168;45;96;105;201
14;42;85;95;263;358
14;112;26;95;69;164
14;175;20;95;92;187
14;56;80;94;177;271
14;168;50;94;87;181
14;168;44;94;108;202
14;133;77;93;129;222
14;84;71;93;144;237
14;28;77;92;149;241
14;175;45;92;67;159
14;112;31;92;100;192
14;175;30;92;89;181
14;175;3;92;80;172
14;49;73;91;98;189
14;112;56;91;45;136
14;112;22;91;67;158
14;133;75;90;156;246
14;168;47;90;116;206
14;91;88;89;180;269
14;7;79;89;120;209
14;28;76;89;156;245
14;105;75;89;130;219
14;175;32;89;76;165
14;105;78;88;97;185
14;168;60;88;81;169
14;175;28;88;76;164
14;112;20;88;105;193
14;84;76;87;104;191
14;49;75;87;107;194
14;133;78;86;136;222
14;35;76;86;83;169
14;49;74;86;101;187
14;126;73;86;81;167
14;49;67;86;113;199
14;168;58;86;69;155
14;112;37;86;80;166
14;126;74;85;91;176
14;168;54;85;87;172
14;175;27;85;85;170
14;112;25;85;87;172
14;140;88;84;233;317
14;112;36;84;68;152
14;175;29;84;87;171
14;112;29;84;89;173
14;161;87;83;166;249
14;21;86;83;214;297
14;119;84;83;165;248
14;7;78;83;116;199
14;112;49;83;55;138
14;175;44;83;66;149
14;42;88;82;119;201
14;161;86;82;172;254
14;56;81;82;122;204
14;28;80;82;159;241
14;133;79;82;124;206
14;168;63;82;72;154
14;112;40;82;88;170
14;98;88;81;248;329
14;21;87;81;177;258
14;168;61;81;56;137
14;112;27;81;109;190
14;147;85;80;109;189
14;35;74;80;75;155
14;49;71;80;93;173
14;112;50;80;78;158
14;133;80;79;117;196
14;112;60;79;50;129
14;112;42;79;80;159
14;175;25;79;68;147
14;140;91;78;132;210
14;105;79;78;89;167
14;49;69;78;112;190
14;168;62;78;66;144
14;175;59;78;50;128
14;168;59;78;71;149
14;112;54;78;52;130
14;168;43;78;89;167
14;112;38;78;79;157
14;112;34;78;88;166
14;63;87;77;176;253
14;133;76;77;169;246
14;35;75;77;97;174
14;175;53;77;59;136
14;175;26;77;92;169
14;7;80;76;141;217
14;35;77;76;80;156
14;168;65;76;59;135
14;168;56;76;67;143
14;168;55;76;93;169
14;175;48;76;63;139
14;175;43;76;86;162
14;175;22;76;83;159
14;84;78;75;113;188
14;175;51;75;47;122
14;112;46;75;73;148
14;175;38;75;64;139
14;147;82;74;152;226
14;56;82;74;116;190
14;175;60;74;84;158
14;112;39;74;66;140
14;112;32;74;97;171
14;112;24;74;75;149
14;84;77;73;105;178
14;126;72;73;90;163
14;112;45;73;66;139
14;112;43;73;72;145
14;175;41;73;66;139
14;7;81;72;109;181
14;126;75;72;95;167
14;175;37;72;60;132
14;98;90;71;181;252
14;182;86;71;142;213
14;133;81;71;108;179
14;28;81;71;98;169
14;175;58;71;55;126
14;112;48;71;67;138
14;112;21;71;103;174
14;175;62;70;46;116
14;14;94;69;323;392
14;35;78;69;71;140
14;105;77;69;85;154
14;175;35;69;69;138
14;175;33;69;72;141
14;112;23;69;79;148
14;126;76;68;77;145
14;175;57;68;68;136
14;175;56;68;50;118
14;175;55;68;50;118
14;175;34;68;64;132
14;175;24;68;97;165
14;147;84;67;137;204
14;35;79;67;82;149
14;168;57;67;74;141
14;175;54;67;69;136
14;112;44;67;84;151
14;175;39;67;87;154
14;175;23;67;77;144
14;63;88;66;137;203
14;147;83;66;144;210
14;175;64;66;58;124
14;175;49;66;67;133
14;21;88;65;135;200
14;175;36;65;82;147
14;77;10;65;62;127
14;182;87;64;145;209
14;28;82;64;120;184
14;84;80;64;103;167
14;49;76;64;95;159
14;168;66;64;58;122
14;112;58;64;52;116
14;77;18;64;38;102
14;70;12;64;45;109
14;105;80;63;80;143
14;168;69;63;68;131
14;112;55;63;58;121
14;175;46;63;63;126
14;112;35;63;101;164
14;119;85;62;149;211
14;84;79;62;111;173
14;112;52;62;82;144
14;168;70;61;61;122
14;112;64;61;49;110
14;175;63;61;49;110
14;175;42;60;60;120
14;161;88;59;127;186
14;175;61;59;45;104
14;112;57;59;47;106
14;175;52;59;64;123
14;154;17;59;41;100
14;77;14;59;45;104
14;119;86;58;131;189
14;168;64;58;69;127
14;77;5;58;46;104
14;56;84;57;90;147
14;28;83;57;99;156
14;133;82;57;99;156
14;7;82;57;114;171
14;154;7;57;36;93
14;98;91;56;135;191
14;7;83;56;98;154
14;126;77;56;68;124
14;175;66;56;68;124
14;112;61;56;53;109
14;112;51;56;51;107
14;175;40;56;83;139
14;70;14;56;50;106
14;77;11;56;51;107
14;154;9;56;47;103
14;70;5;56;38;94
14;112;65;55;50;105
14;70;17;55;44;99
14;154;13;55;42;97
14;77;2;55;50;105
14;84;83;54;88;142
14;175;70;54;62;116
14;175;65;54;53;107
14;77;17;54;41;95
14;182;88;53;111;164
14;126;80;53;67;120
14;126;79;53;69;122
14;49;79;53;68;121
14;175;68;53;57;110
14;112;63;53;44;97
14;112;53;53;68;121
14;56;83;52;116;168
14;35;80;52;83;135
14;49;78;52;79;131
14;49;77;52;92;144
14;77;16;52;44;96
14;154;15;52;48;100
14;28;84;51;81;132
14;49;72;51;93;144
14;112;59;51;40;91
14;154;16;51;52;103
14;70;16;51;52;103
14;77;13;51;45;96
14;70;9;51;45;96
14;77;7;51;49;100
14;154;14;50;38;88
14;77;12;50;41;91
14;140;89;49;184;233
14;7;84;49;81;130
14;49;80;49;62;111
14;168;71;49;46;95
14;175;67;49;39;88
14;112;66;49;38;87
14;70;15;49;52;101
14;105;81;48;84;132
14;168;67;48;46;94
14;112;62;48;49;97
14;154;12;48;44;92
14;91;90;47;153;200
14;98;89;47;289;336
14;147;86;47;104;151
14;42;86;47;198;245
14;133;83;47;101;148
14;84;81;47;75;122
14;126;78;47;83;130
14;70;18;47;42;89
14;70;11;47;42;89
14;182;90;46;96;142
14;182;89;46;84;130
14;119;87;46;114;160
14;7;85;46;72;118
14;112;68;46;38;84
14;154;10;46;49;95
14;140;90;45;144;189
14;147;87;45;83;128
14;35;81;45;56;101
14;168;68;45;53;98
14;77;30;45;34;79
14;77;19;45;37;82
14;154;11;45;43;88
14;77;8;45;44;89
14;70;8;45;48;93
14;77;3;45;42;87
14;126;81;44;65;109
14;77;47;44;28;72
14;70;10;44;55;99
14;154;8;44;50;94
14;154;6;44;51;95
14;77;0;44;41;85
14;91;89;43;178;221
14;133;86;43;79;122
14;56;86;43;71;114
14;56;85;43;93;136
14;77;15;43;54;97
14;77;6;43;49;92
14;133;84;42;70;112
14;168;72;42;46;88
14;154;19;42;33;75
14;154;3;42;47;89
14;70;2;42;37;79
14;70;0;42;33;75
14;175;69;41;43;84
14;70;19;41;34;75
14;154;18;41;37;78
14;21;89;40;109;149
14;84;82;40;78;118
14;77;41;40;31;71
14;154;30;40;30;70
14;154;26;40;29;69
14;77;22;40;43;83
14;77;1;40;41;81
14;98;94;39;70;109
14;7;86;39;62;101
14;105;83;39;65;104
14;105;82;39;57;96
14;49;81;39;72;111
14;168;74;39;51;90
14;175;72;39;40;79
14;154;22;39;26;65
14;70;13;39;51;90
14;77;4;39;29;68
14;63;89;38;132;170
14;119;88;38;88;126
14;42;87;38;119;157
14;28;85;38;62;100
14;84;84;38;77;115
14;35;82;38;57;95
14;175;74;38;32;70
14;77;31;38;40;78
14;154;20;38;28;66
14;77;20;38;33;71
14;77;9;38;47;85
14;168;75;37;48;85
14;77;46;37;17;54
14;77;34;37;37;74
14;154;31;37;41;78
14;154;27;37;43;80
14;77;24;37;33;70
14;70;3;37;37;74
14;154;1;37;38;75
14;70;1;37;25;62
14;49;83;36;63;99
14;126;82;36;50;86
14;175;77;36;35;71
14;175;75;36;40;76
14;175;73;36;37;73
14;112;69;36;41;77
14;112;67;36;36;72
14;77;61;36;25;61
14;77;38;36;33;69
14;77;32;36;33;69
14;70;20;36;30;66
14;70;6;36;50;86
14;154;0;36;42;78
14;14;96;35;159;194
14;98;92;35;95;130
14;70;42;35;16;51
14;154;41;35;28;63
14;70;38;35;22;57
14;77;33;35;27;62
14;70;7;35;34;69
14;70;4;35;29;64
14;161;89;34;118;152
14;133;85;34;68;102
14;35;85;34;51;85
14;175;78;34;25;59
14;168;76;34;31;65
14;112;71;34;32;66
14;112;70;34;32;66
14;154;61;34;17;51
14;77;56;34;23;57
14;77;48;34;21;55
14;70;45;34;23;57
14;77;44;34;32;66
14;70;39;34;26;60
14;154;4;34;36;70
14;175;76;33;25;58
14;168;73;33;37;70
14;70;60;33;15;48
14;77;55;33;31;64
14;77;50;33;22;55
14;70;47;33;28;61
14;77;45;33;32;65
14;70;40;33;36;69
14;77;36;33;23;56
14;70;30;33;30;63
14;77;23;33;35;68
14;21;90;32;99;131
14;133;87;32;59;91
14;7;87;32;47;79
14;77;58;32;17;49
14;77;54;32;40;72
14;154;47;32;18;50
14;77;43;32;40;72
14;70;28;32;30;62
14;154;21;32;33;65
14;63;90;31;101;132
14;49;84;31;57;88
14;112;73;31;31;62
14;70;49;31;23;54
14;70;48;31;24;55
14;154;42;31;17;48
14;154;38;31;30;61
14;70;25;31;28;59
14;154;24;31;27;58
14;21;91;30;60;90
14;161;90;30;95;125
14;119;90;30;57;87
14;28;86;30;54;84
14;126;83;30;49;79
14;112;72;30;35;65
14;77;68;30;18;48
14;77;65;30;27;57
14;70;65;30;14;44
14;77;59;30;24;54
14;70;56;30;18;48
14;154;46;30;25;55
14;70;34;30;30;60
14;14;95;29;240;269
14;140;94;29;59;88
14;140;92;29;123;152
14;56;88;29;56;85
14;35;83;29;60;89
14;70;57;29;18;47
14;154;55;29;19;48
14;70;53;29;26;55
14;154;43;29;23;52
14;154;36;29;27;56
14;77;29;29;29;58
14;154;5;29;46;75
14;154;2;29;36;65
14;42;89;28;142;170
14;28;88;28;46;74
14;105;84;28;66;94
14;175;71;28;34;62
14;154;54;28;17;45
14;154;53;28;19;47
14;77;53;28;26;54
14;77;52;28;31;59
14;154;44;28;25;53
14;70;43;28;13;41
14;154;39;28;14;42
14;77;39;28;49;77
14;154;37;28;29;57
14;77;37;28;26;54
14;70;36;28;31;59
14;70;32;28;26;54
14;70;31;28;23;51
14;77;28;28;26;54
14;70;27;28;30;58
14;77;21;28;32;60
14;56;87;27;66;93
14;35;84;27;52;79
14;49;82;27;55;82
14;112;76;27;23;50
14;70;61;27;24;51
14;70;55;27;18;45
14;70;54;27;26;53
14;70;52;27;24;51
14;154;48;27;29;56
14;154;45;27;33;60
14;77;40;27;35;62
14;154;29;27;29;56
14;77;27;27;32;59
14;70;22;27;32;59
14;70;21;27;25;52
14;42;91;26;72;98
14;84;85;26;64;90
14;77;70;26;22;48
14;77;66;26;28;54
14;77;60;26;35;61
14;70;58;26;17;43
14;154;56;26;15;41
14;77;49;26;20;46
14;77;42;26;29;55
14;70;35;26;28;54
14;154;33;26;36;62
14;154;32;26;31;57
14;77;26;26;28;54
14;70;26;26;25;51
14;140;93;25;77;102
14;147;88;25;65;90
14;168;81;25;22;47
14;175;80;25;28;53
14;168;78;25;19;44
14;112;74;25;23;48
14;77;62;25;22;47
14;154;59;25;18;43
14;154;57;25;18;43
14;70;50;25;22;47
14;154;49;25;20;45
14;70;29;25;33;58
14;77;25;25;35;60
14;42;92;24;52;76
14;161;91;24;76;100
14;91;91;24;74;98
14;7;88;24;43;67
14;168;79;24;25;49
14;77;69;24;18;42
14;154;63;24;19;43
14;154;62;24;20;44
14;70;51;24;23;47
14;70;46;24;25;49
14;70;41;24;29;53
14;154;35;24;24;48
14;154;23;24;25;49
14;7;90;23;41;64
14;147;89;23;50;73
14;119;89;23;85;108
14;56;89;23;54;77
14;84;86;23;60;83
14;35;86;23;46;69
14;49;85;23;44;67
14;77;67;23;13;36
14;154;65;23;18;41
14;154;60;23;24;47
14;154;58;23;16;39
14;77;57;23;19;42
14;154;50;23;16;39
14;77;35;23;38;61
14;70;33;23;28;51
14;70;23;23;27;50
14;42;90;22;79;101
14;7;89;22;45;67
14;126;85;22;40;62
14;70;64;22;20;42
14;70;63;22;24;46
14;154;51;22;16;38
14;133;89;21;36;57
14;105;87;21;33;54
14;84;87;21;49;70
14;49;87;21;31;52
14;105;85;21;44;65
14;126;84;21;49;70
14;168;77;21;37;58
14;77;51;21;24;45
14;70;37;21;32;53
14;154;25;21;30;51
14;14;98;20;75;95
14;63;91;20;74;94
14;133;88;20;59;79
14;49;86;20;42;62
14;168;83;20;23;43
14;168;80;20;24;44
14;70;70;20;19;39
14;77;63;20;27;47
14;70;62;20;26;46
14;70;44;20;21;41
14;154;40;20;20;40
14;14;97;19;116;135
14;91;95;19;32;51
14;28;89;19;29;48
14;84;88;19;52;71
14;175;81;19;25;44
14;70;75;19;11;30
14;77;74;19;17;36
14;77;73;19;18;37
14;154;69;19;14;33
14;70;66;19;16;35
14;154;64;19;20;39
14;70;59;19;23;42
14;154;28;19;34;53
14;119;91;18;38;56
14;147;90;18;49;67
14;28;90;18;29;47
14;112;78;18;21;39
14;112;77;18;27;45
14;98;95;17;52;69
14;63;92;17;60;77
14;112;80;17;17;34
14;175;79;17;30;47
14;77;76;17;13;30
14;154;73;17;15;32
14;70;69;17;16;33
14;77;64;17;26;43
14;70;24;17;16;33
14;182;92;16;45;61
14;21;92;16;58;74
14;182;91;16;68;84
14;56;91;16;31;47
14;105;88;16;36;52
14;35;87;16;31;47
14;28;87;16;62;78
14;105;86;16;51;67
14;168;84;16;30;46
14;168;82;16;24;40
14;77;72;16;26;42
14;91;92;15;69;84
14;126;87;15;33;48
14;175;83;15;18;33
14;77;78;15;15;30
14;77;75;15;19;34
14;70;74;15;16;31
14;70;73;15;19;34
14;154;70;15;10;25
14;70;68;15;30;45
14;140;96;14;23;37
14;182;93;14;40;54
14;98;93;14;91;105
14;133;90;14;34;48
14;126;86;14;32;46
14;175;84;14;16;30
14;112;81;14;17;31
14;154;71;14;14;28
14;154;67;14;13;27
14;70;67;14;16;30
14;154;66;14;19;33
14;154;34;14;25;39
14;42;94;13;30;43
14;21;94;13;25;38
14;161;92;13;56;69
14;105;89;13;21;34
14;35;89;13;27;40
14;126;88;13;34;47
14;175;85;13;16;29
14;168;85;13;25;38
14;175;82;13;24;37
14;77;80;13;15;28
14;70;79;13;11;24
14;112;75;13;34;47
14;154;74;13;8;21
14;154;72;13;9;22
14;77;71;13;16;29
14;70;71;13;18;31
14;21;93;12;52;64
14;126;90;12;17;29
14;56;90;12;36;48
14;126;89;12;23;35
14;49;88;12;32;44
14;175;86;12;11;23
14;112;84;12;16;28
14;70;80;12;20;32
14;112;79;12;26;38
14;77;77;12;12;24
14;70;77;12;9;21
14;154;68;12;12;24
14;133;93;11;20;31
14;63;93;11;50;61
14;35;90;11;24;35
14;35;88;11;29;40
14;77;82;11;13;24
14;154;79;11;8;19
14;70;76;11;21;32
14;154;75;11;16;27
14;70;72;11;14;25
14;154;52;11;25;36
14;161;93;10;32;42
14;147;91;10;33;43
14;28;91;10;28;38
14;7;91;10;19;29
14;105;90;10;22;32
14;84;90;10;36;46
14;49;90;10;14;24
14;84;89;10;35;45
14;77;84;10;12;22
14;112;83;10;9;19
14;77;79;10;9;19
14;14;110;9;0;9
14;63;95;9;24;33
14;119;94;9;23;32
14;91;93;9;61;70
14;84;92;9;15;24
14;175;88;9;11;20
14;112;82;9;26;35
14;77;81;9;10;19
14;161;96;8;17;25
14;182;94;8;25;33
14;105;94;8;8;16
14;63;94;8;41;49
14;119;93;8;21;29
14;119;92;8;24;32
14;28;92;8;12;20
14;168;89;8;12;20
14;175;87;8;11;19
14;168;86;8;15;23
14;112;85;8;19;27
14;154;80;8;6;14
14;154;78;8;10;18
14;70;78;8;19;27
14;91;97;7;32;39
14;161;94;7;29;36
14;147;94;7;11;18
14;91;94;7;46;53
14;42;93;7;17;24
14;35;93;7;10;17
14;28;93;7;12;19
14;133;92;7;18;25
14;35;92;7;16;23
14;7;92;7;13;20
14;133;91;7;32;39
14;84;91;7;25;32
14;49;91;7;22;29
14;112;87;7;12;19
14;154;83;7;9;16
14;77;83;7;10;17
14;91;98;6;11;17
14;21;96;6;17;23
14;140;95;6;56;62
14;21;95;6;28;34
14;56;93;6;16;22
14;56;92;6;24;30
14;49;89;6;25;31
14;168;88;6;11;17
14;168;87;6;20;26
14;77;86;6;7;13
14;70;83;6;10;16
14;154;82;6;10;16
14;70;82;6;5;11
14;70;81;6;6;12
14;63;97;5;14;19
14;147;93;5;23;28
14;147;92;5;30;35
14;126;91;5;17;22
14;112;89;5;4;9
14;154;81;5;6;11
14;154;76;5;13;18
14;21;97;4;7;11
14;161;95;4;18;22
14;119;95;4;10;14
14;84;94;4;10;14
14;28;94;4;7;11
14;7;94;4;12;16
14;7;93;4;7;11
14;126;92;4;8;12
14;105;92;4;8;12
14;112;91;4;3;7
14;175;89;4;9;13
14;154;87;4;5;9
14;154;86;4;2;6
14;112;86;4;12;16
14;77;85;4;5;9
14;70;85;4;8;12
14;154;77;4;7;11
14;21;101;3;3;6
14;161;97;3;10;13
14;182;96;3;11;14
14;35;96;3;4;7
14;28;96;3;10;13
14;7;96;3;8;11
14;182;95;3;12;15
14;147;95;3;8;11
14;28;95;3;6;9
14;133;94;3;4;7
14;56;94;3;15;18
14;126;93;3;10;13
14;77;93;3;1;4
14;49;93;3;11;14
14;175;91;3;8;11
14;168;91;3;6;9
14;105;91;3;22;25
14;175;90;3;10;13
14;168;90;3;12;15
14;77;90;3;6;9
14;70;90;3;1;4
14;70;89;3;7;10
14;154;88;3;1;4
14;112;88;3;5;8
14;70;87;3;5;8
14;154;85;3;5;8
14;154;84;3;4;7
14;70;84;3;7;10
14;91;104;2;3;5
14;119;102;2;1;3
14;91;100;2;7;9
14;182;99;2;4;6
14;161;99;2;3;5
14;14;99;2;25;27
14;161;98;2;2;4
14;147;98;2;3;5
14;140;98;2;5;7
14;119;98;2;8;10
14;21;98;2;12;14
14;140;97;2;9;11
14;98;97;2;27;29
14;84;97;2;1;3
14;133;96;2;8;10
14;126;96;2;2;4
14;126;95;2;6;8
14;105;95;2;6;8
14;56;95;2;7;9
14;7;95;2;4;6
14;126;94;2;5;7
14;49;94;2;7;9
14;35;94;2;9;11
14;84;93;2;17;19
14;70;93;2;0;2
14;49;92;2;10;12
14;154;91;2;0;2
14;154;90;2;1;3
14;154;89;2;6;8
14;77;89;2;5;7
14;77;88;2;3;5
14;70;88;2;4;6
14;14;107;1;1;2
14;91;103;1;1;2
14;35;103;1;0;1
14;14;103;1;2;3
14;182;101;1;1;2
14;49;101;1;1;2
14;7;101;1;1;2
14;140;100;1;2;3
14;98;100;1;4;5
14;42;100;1;2;3
14;28;100;1;0;1
14;21;100;1;3;4
14;7;100;1;0;1
14;112;99;1;0;1
14;56;99;1;1;2
14;28;99;1;1;2
14;7;99;1;2;3
14;133;98;1;2;3
14;126;98;1;2;3
14;84;98;1;3;4
14;77;98;1;0;1
14;56;98;1;3;4
14;42;98;1;5;6
14;7;98;1;1;2
14;182;97;1;10;11
14;133;97;1;8;9
14;105;97;1;4;5
14;77;97;1;0;1
14;49;97;1;2;3
14;35;97;1;4;5
14;28;97;1;3;4
14;147;96;1;11;12
14;119;96;1;8;9
14;112;96;1;2;3
14;105;96;1;6;7
14;98;96;1;47;48
14;84;96;1;7;8
14;70;96;1;3;4
14;56;96;1;4;5
14;49;96;1;3;4
14;42;96;1;25;26
14;133;95;1;13;14
14;84;95;1;8;9
14;49;95;1;6;7
14;42;95;1;12;13
14;35;95;1;7;8
14;168;94;1;4;5
14;77;94;1;3;4
14;70;94;1;0;1
14;175;93;1;3;4
14;105;93;1;9;10
14;175;92;1;6;7
14;168;92;1;2;3
14;112;92;1;1;2
14;77;92;1;1;2
14;70;92;1;0;1
14;77;91;1;3;4
14;70;91;1;5;6
14;35;91;1;12;13
14;112;90;1;5;6
14;77;87;1;5;6
14;98;109;0;1;1
14;98;108;0;1;1
14;91;105;0;2;2
14;14;105;0;1;1
14;182;104;0;2;2
14;140;104;0;1;1
14;42;104;0;1;1
14;182;103;0;1;1
14;161;103;0;1;1
14;133;103;0;2;2
14;112;103;0;1;1
14;98;103;0;1;1
14;63;103;0;1;1
14;56;103;0;1;1
14;49;103;0;1;1
14;28;103;0;1;1
14;21;103;0;1;1
14;7;103;0;1;1
14;154;102;0;1;1
14;140;102;0;2;2
14;126;102;0;1;1
14;98;102;0;1;1
14;91;102;0;4;4
14;56;102;0;1;1
14;42;102;0;1;1
14;35;102;0;1;1
14;14;102;0;33;33
14;7;102;0;2;2
14;175;101;0;1;1
14;154;101;0;1;1
14;140;101;0;1;1
14;133;101;0;1;1
14;119;101;0;1;1
14;105;101;0;1;1
14;98;101;0;12;12
14;91;101;0;15;15
14;84;101;0;2;2
14;63;101;0;2;2
14;42;101;0;2;2
14;14;101;0;5;5
14;182;100;0;4;4
14;168;100;0;1;1
14;161;100;0;4;4
14;147;100;0;1;1
14;133;100;0;1;1
14;126;100;0;1;1
14;119;100;0;3;3
14;105;100;0;2;2
14;63;100;0;1;1
14;56;100;0;1;1
14;35;100;0;1;1
14;14;100;0;49;49
14;147;99;0;3;3
14;140;99;0;12;12
14;133;99;0;3;3
14;126;99;0;2;2
14;119;99;0;2;2
14;98;99;0;6;6
14;91;99;0;4;4
14;84;99;0;1;1
14;63;99;0;5;5
14;49;99;0;4;4
14;42;99;0;1;1
14;35;99;0;1;1
14;21;99;0;7;7
14;182;98;0;8;8
14;112;98;0;1;1
14;105;98;0;1;1
14;98;98;0;18;18
14;63;98;0;7;7
14;49;98;0;1;1
14;35;98;0;1;1
14;28;98;0;9;9
14;175;97;0;1;1
14;168;97;0;1;1
14;154;97;0;1;1
14;147;97;0;5;5
14;126;97;0;1;1
14;119;97;0;8;8
14;56;97;0;1;1
14;42;97;0;2;2
14;7;97;0;1;1
14;175;96;0;1;1
14;168;96;0;2;2
14;91;96;0;34;34
14;77;96;0;1;1
14;63;96;0;23;23
14;175;95;0;3;3
14;168;95;0;3;3
14;112;95;0;1;1
14;77;95;0;1;1
14;70;95;0;2;2
14;175;94;0;4;4
14;154;94;0;3;3
14;112;94;0;1;1
14;168;93;0;5;5
14;112;93;0;3;3
14;154;92;0;2;2
14;70;86;0;5;5
58;35;2;3750;3110;6860
58;35;11;3643;2938;6581
58;35;19;3588;3655;7243
58;35;20;3411;3349;6760
58;35;1;3372;3171;6543
58;35;22;3360;2930;6290
58;35;17;3311;3579;6890
58;35;14;3293;3011;6304
58;35;9;3280;2665;5945
58;35;16;3279;3244;6523
58;35;25;3269;2981;6250
58;35;18;3268;3655;6923
58;35;10;3256;2969;6225
58;35;5;3254;2910;6164
58;35;21;3242;2983;6225
58;35;13;3238;3157;6395
58;35;0;3203;3170;6373
58;35;15;3200;3208;6408
58;35;3;3199;2983;6182
58;35;23;3143;2945;6088
58;35;28;3133;3138;6271
58;35;4;3097;3136;6233
58;35;31;3080;3275;6355
58;35;30;3080;3215;6295
58;35;8;3036;2859;5895
58;35;12;3035;2890;5925
58;35;29;3001;3246;6247
58;35;24;2968;3321;6289
58;35;6;2937;2767;5704
58;35;27;2933;3070;6003
58;35;32;2864;2878;5742
58;35;33;2859;3204;6063
58;35;35;2779;2918;5697
58;35;26;2729;2800;5529
58;35;38;2678;2789;5467
58;35;34;2650;2793;5443
58;35;7;2585;2857;5442
58;35;37;2537;2909;5446
58;35;40;2450;2609;5059
58;35;46;2275;2497;4772
58;35;36;2271;2659;4930
58;35;39;2186;2584;4770
58;35;41;2123;2419;4542
58;35;47;2097;2315;4412
58;35;48;2050;2233;4283
58;35;44;1985;2281;4266
58;35;45;1961;2406;4367
58;35;50;1884;2091;3975
58;35;49;1874;1990;3864
58;35;53;1865;1827;3692
58;35;42;1855;2284;4139
58;35;43;1852;2164;4016
58;35;52;1811;1946;3757
58;35;57;1762;1773;3535
58;35;55;1735;1678;3413
58;35;54;1734;2098;3832
58;35;51;1714;2059;3773
58;35;56;1582;1690;3272
58;35;58;1550;1769;3319
58;35;60;1461;1651;3112
58;35;59;1419;1652;3071
58;35;62;1295;1442;2737
58;35;61;1216;1394;2610
58;35;64;1205;1144;2349
58;35;65;1123;1179;2302
58;35;63;1072;1138;2210
58;35;67;870;761;1631
58;35;66;832;953;1785
58;35;70;807;901;1708
58;35;69;789;930;1719
58;35;68;785;832;1617
58;35;71;590;701;1291
58;35;72;564;678;1242
58;35;74;480;549;1029
58;35;73;464;815;1279
58;35;75;416;672;1088
58;35;76;412;710;1122
58;112;18;402;347;749
58;35;77;400;576;976
58;112;19;380;352;732
58;112;15;380;344;724
58;112;13;380;336;716
58;112;17;377;366;743
58;112;16;365;385;750
58;112;3;362;326;688
58;112;1;357;335;692
58;112;20;355;355;710
58;112;11;355;305;660
58;112;14;354;374;728
58;112;10;354;336;690
58;112;12;350;334;684
58;35;79;346;368;714
58;112;4;346;305;651
58;112;2;345;320;665
58;112;6;342;327;669
58;112;0;342;340;682
58;112;21;340;295;635
58;91;31;328;249;577
58;112;5;328;292;620
58;112;9;327;315;642
58;112;8;325;339;664
58;112;7;325;299;624
58;112;22;317;285;602
58;35;78;316;537;853
58;91;30;310;272;582
58;91;33;304;239;543
58;91;3;304;258;562
58;35;80;303;506;809
58;91;1;302;301;603
58;91;32;300;234;534
58;112;30;296;292;588
58;56;14;296;274;570
58;56;2;293;253;546
58;56;1;292;267;559
58;56;11;291;243;534
58;112;32;288;303;591
58;91;2;288;265;553
58;56;15;287;284;571
58;56;12;287;229;516
58;112;25;286;274;560
58;56;13;286;252;538
58;91;29;283;267;550
58;112;24;282;296;578
58;56;5;282;289;571
58;112;23;281;290;571
58;56;17;278;281;559
58;56;10;278;266;544
58;56;16;277;287;564
58;56;3;276;281;557
58;112;33;275;268;543
58;56;0;275;296;571
58;56;8;274;262;536
58;91;36;273;177;450
58;91;28;273;258;531
58;112;28;272;299;571
58;112;29;271;318;589
58;91;26;271;232;503
58;112;35;267;317;584
58;91;5;267;263;530
58;112;36;265;274;539
58;91;35;263;194;457
58;91;0;263;283;546
58;91;34;262;203;465
58;56;4;262;260;522
58;56;33;260;279;539
58;56;6;260;276;536
58;112;37;259;258;517
58;56;18;259;208;467
58;112;34;258;290;548
58;112;26;258;286;544
58;56;19;258;228;486
58;56;7;258;239;497
58;56;37;256;236;492
58;112;27;256;268;524
58;91;37;255;178;433
58;56;32;254;250;504
58;56;9;252;260;512
58;91;10;251;242;493
58;91;11;250;216;466
58;91;4;246;262;508
58;56;30;243;288;531
58;56;31;242;283;525
58;112;38;241;248;489
58;91;9;240;220;460
58;91;14;238;211;449
58;56;24;237;205;442
58;56;36;236;253;489
58;56;34;236;257;493
58;91;38;234;164;398
58;56;42;233;196;429
58;112;31;233;301;534
58;56;29;233;227;460
58;91;8;233;228;461
58;91;7;233;215;448
58;56;40;232;231;463
58;91;12;231;227;458
58;56;35;230;250;480
58;91;15;230;217;447
58;56;20;229;200;429
58;91;25;226;209;435
58;56;38;224;262;486
58;91;27;224;248;472
58;91;18;223;175;398
58;112;39;222;258;480
58;112;45;221;240;461
58;91;41;221;123;344
58;56;39;220;271;491
58;112;46;219;242;461
58;56;23;219;213;432
58;56;21;219;217;436
58;91;13;217;231;448
58;56;26;216;204;420
58;56;41;213;204;417
58;112;40;213;231;444
58;91;17;213;195;408
58;91;6;213;236;449
58;112;44;212;257;469
58;112;42;211;241;452
58;112;47;208;236;444
58;56;25;206;197;403
58;35;81;205;341;546
58;112;48;205;210;415
58;56;28;205;249;454
58;91;40;203;158;361
58;56;47;201;187;388
58;91;24;201;208;409
58;56;22;201;200;401
58;112;41;197;239;436
58;91;16;197;191;388
58;112;52;196;168;364
58;91;39;196;134;330
58;56;46;192;200;392
58;56;45;189;198;387
58;91;43;189;114;303
58;56;44;188;210;398
58;42;18;187;162;349
58;42;15;187;172;359
58;49;15;185;176;361
58;35;82;184;367;551
58;91;21;184;183;367
58;112;56;183;180;363
58;112;50;183;231;414
58;112;43;183;214;397
58;56;27;183;208;391
58;56;48;182;196;378
58;56;50;179;164;343
58;112;54;177;171;348
58;112;53;176;169;345
58;91;20;176;196;372
58;42;14;176;158;334
58;112;49;175;218;393
58;56;43;175;212;387
58;91;23;175;217;392
58;42;19;173;158;331
58;49;17;172;153;325
58;56;51;170;176;346
58;91;22;170;180;350
58;56;49;167;166;333
58;91;42;167;143;310
58;42;17;166;164;330
58;91;19;165;178;343
58;112;51;164;196;360
58;49;19;163;123;286
58;91;44;162;107;269
58;49;18;161;134;295
58;42;22;157;116;273
58;49;16;157;152;309
58;35;83;156;278;434
58;112;55;156;165;321
58;42;16;155;191;346
58;49;14;152;178;330
58;42;13;149;158;307
58;112;57;147;144;291
58;56;53;147;140;287
58;56;52;147;155;302
58;42;11;147;144;291
58;49;6;147;133;280
58;42;0;146;148;294
58;91;45;145;103;248
58;112;60;144;129;273
58;56;55;144;103;247
58;91;48;144;62;206
58;49;11;144;132;276
58;91;46;142;117;259
58;49;3;142;122;264
58;42;21;141;122;263
58;42;10;141;141;282
58;49;1;140;144;284
58;112;59;139;154;293
58;56;54;139;161;300
58;49;28;139;101;240
58;42;4;139;124;263
58;49;23;138;116;254
58;42;23;138;108;246
58;42;20;138;150;288
58;49;9;138;117;255
58;42;9;138;134;272
58;42;6;138;105;243
58;42;3;137;130;267
58;42;1;137;123;260
58;56;56;136;144;280
58;70;14;136;107;243
58;49;10;136;163;299
58;42;12;135;128;263
58;49;8;135;135;270
58;112;58;134;153;287
58;49;24;134;119;253
58;49;21;134;122;256
58;42;7;134;103;237
58;49;2;134;150;284
58;70;1;134;99;233
58;49;34;133;121;254
58;49;13;133;144;277
58;49;12;133;116;249
58;49;0;133;141;274
58;14;0;133;122;255
58;14;1;132;134;266
58;91;49;131;66;197
58;42;29;130;123;253
58;42;8;130;118;248
58;42;28;129;146;275
58;49;26;129;124;253
58;42;2;129;139;268
58;49;22;128;136;264
58;112;61;127;130;257
58;14;17;127;114;241
58;49;4;127;134;261
58;14;4;127;115;242
58;49;29;126;138;264
58;49;20;126;118;244
58;49;7;126;129;255
58;91;47;125;82;207
58;49;33;125;104;229
58;14;5;125;127;252
58;70;4;124;99;223
58;35;85;123;228;351
58;49;30;123;145;268
58;49;25;123;141;264
58;112;63;122;109;231
58;42;24;122;111;233
58;70;9;122;102;224
58;42;33;121;133;254
58;70;13;121;115;236
58;42;5;121;116;237
58;70;2;121;112;233
58;91;50;120;93;213
58;42;32;120;134;254
58;70;30;120;103;223
58;14;2;120;128;248
58;42;35;119;123;242
58;35;87;118;218;336
58;56;59;118;109;227
58;56;57;118;125;243
58;91;52;118;78;196
58;49;36;118;105;223
58;49;31;118;150;268
58;49;35;117;124;241
58;70;33;117;142;259
58;70;17;117;95;212
58;14;11;117;102;219
58;91;54;116;67;183
58;42;37;116;131;247
58;14;14;116;108;224
58;91;51;115;73;188
58;42;34;115;112;227
58;14;3;115;125;240
58;49;40;114;101;215
58;49;27;114;120;234
58;42;44;113;96;209
58;42;30;113;135;248
58;14;12;113;99;212
58;49;5;113;141;254
58;91;53;112;58;170
58;56;60;111;132;243
58;14;26;111;98;209
58;14;20;111;127;238
58;14;18;111;108;219
58;35;86;110;204;314
58;70;35;110;112;222
58;70;21;110;56;166
58;70;15;110;102;212
58;14;13;110;99;209
58;14;6;110;108;218
58;14;29;109;98;207
58;14;28;109;88;197
58;14;23;109;91;200
58;70;10;109;94;203
58;70;38;108;116;224
58;42;38;108;136;244
58;42;26;108;126;234
58;14;19;108;129;237
58;14;16;108;115;223
58;56;58;107;126;233
58;70;39;107;106;213
58;70;28;107;89;196
58;70;16;107;104;211
58;70;34;106;107;213
58;70;41;105;77;182
58;70;36;105;95;200
58;42;27;105;116;221
58;14;8;105;101;206
58;70;0;105;108;213
58;49;32;104;117;221
58;14;31;104;87;191
58;49;39;103;90;193
58;42;36;103;127;230
58;70;11;103;105;208
58;70;31;102;119;221
58;14;15;102;113;215
58;56;61;101;105;206
58;42;39;101;127;228
58;70;6;101;114;215
58;42;47;100;99;199
58;49;45;100;87;187
58;49;38;100;131;231
58;14;24;100;91;191
58;70;18;100;90;190
58;14;9;100;103;203
58;112;62;99;121;220
58;42;42;99;93;192
58;42;41;99;116;215
58;70;40;99;83;182
58;70;37;99;108;207
58;105;16;99;76;175
58;42;46;98;108;206
58;42;31;98;130;228
58;14;30;98;105;203
58;14;27;98;97;195
58;14;7;98;103;201
58;7;0;98;78;176
58;42;43;97;90;187
58;14;33;97;77;174
58;70;27;97;95;192
58;42;25;97;122;219
58;14;10;97;112;209
58;14;25;96;81;177
58;7;16;96;101;197
58;77;15;96;73;169
58;70;5;96;111;207
58;91;56;95;64;159
58;70;42;94;90;184
58;14;22;94;95;189
58;77;13;94;79;173
58;56;62;93;92;185
58;42;45;93;106;199
58;70;23;93;79;172
58;14;21;93;84;177
58;14;38;92;60;152
58;70;32;92;114;206
58;70;25;92;87;179
58;77;12;92;84;176
58;56;65;91;79;170
58;49;42;91;82;173
58;49;37;91;123;214
58;70;26;91;82;173
58;7;19;91;70;161
58;70;3;91;103;194
58;112;64;90;113;203
58;49;48;90;86;176
58;14;32;90;78;168
58;105;14;90;80;170
58;7;4;90;71;161
58;56;64;89;89;178
58;70;45;89;93;182
58;49;44;89;72;161
58;70;43;89;86;175
58;42;40;89;108;197
58;14;34;89;76;165
58;77;16;89;83;172
58;7;1;89;72;161
58;91;58;88;68;156
58;42;55;88;55;143
58;49;50;88;74;162
58;70;29;88;94;182
58;70;19;88;79;167
58;70;12;88;83;171
58;14;37;87;65;152
58;77;11;87;71;158
58;35;84;86;280;366
58;49;47;86;84;170
58;70;44;86;65;151
58;7;11;86;79;165
58;77;35;85;61;146
58;63;18;85;61;146
58;77;14;85;69;154
58;105;0;85;80;165
58;49;51;84;71;155
58;49;43;84;107;191
58;77;33;84;83;167
58;105;12;84;68;152
58;63;2;84;78;162
58;56;66;83;85;168
58;91;55;83;58;141
58;14;39;83;59;142
58;14;36;83;59;142
58;14;35;83;83;166
58;70;24;83;81;164
58;7;14;83;93;176
58;70;8;83;111;194
58;105;7;83;55;138
58;56;67;82;77;159
58;112;65;82;107;189
58;105;10;82;73;155
58;63;9;82;69;151
58;7;9;82;70;152
58;7;3;82;79;161
58;42;52;81;66;147
58;7;10;81;67;148
58;7;7;81;70;151
58;112;69;80;83;163
58;42;53;80;76;156
58;42;50;80;63;143
58;49;46;80;93;173
58;70;20;80;85;165
58;7;17;80;96;176
58;112;66;79;104;183
58;56;63;79;94;173
58;91;57;79;44;123
58;7;35;79;65;144
58;70;22;79;77;156
58;7;12;79;89;168
58;63;3;79;58;137
58;112;68;78;77;155
58;49;49;78;66;144
58;77;18;78;77;155
58;63;15;78;64;142
58;105;11;78;69;147
58;7;6;78;85;163
58;70;52;77;65;142
58;42;49;77;72;149
58;70;48;77;73;150
58;14;41;77;60;137
58;7;38;77;59;136
58;105;35;77;47;124
58;7;31;77;66;143
58;105;15;77;104;181
58;105;5;77;58;135
58;7;2;77;83;160
58;77;1;77;69;146
58;70;46;76;77;153
58;49;41;76;101;177
58;105;6;76;66;142
58;77;6;76;69;145
58;42;54;75;73;148
58;28;14;75;50;125
58;77;10;75;82;157
58;7;8;75;81;156
58;70;7;75;92;167
58;70;50;74;61;135
58;70;47;74;71;145
58;7;27;74;63;137
58;7;13;74;74;148
58;14;45;73;52;125
58;7;32;73;66;139
58;7;18;73;88;161
58;63;16;73;89;162
58;63;11;73;67;140
58;63;10;73;62;135
58;63;0;73;58;131
58;77;34;72;60;132
58;7;30;72;79;151
58;105;8;72;68;140
58;105;4;72;60;132
58;112;67;71;101;172
58;70;49;71;83;154
58;77;38;71;48;119
58;7;37;71;63;134
58;7;25;71;78;149
58;105;13;71;67;138
58;91;60;70;49;119
58;91;59;70;39;109
58;42;51;70;68;138
58;77;30;70;56;126
58;105;17;70;91;161
58;14;42;69;50;119
58;14;40;69;86;155
58;77;36;69;69;138
58;63;30;69;68;137
58;7;26;69;64;133
58;63;19;69;64;133
58;105;18;69;69;138
58;77;4;69;55;124
58;7;29;68;58;126
58;7;20;68;57;125
58;63;13;68;62;130
58;28;10;68;46;114
58;77;39;67;45;112
58;105;19;67;45;112
58;63;12;67;68;135
58;63;7;67;68;135
58;105;3;67;63;130
58;77;3;67;60;127
58;70;53;66;66;132
58;42;48;66;86;152
58;7;33;66;59;125
58;105;28;66;57;123
58;77;20;66;51;117
58;105;9;66;59;125
58;77;8;66;56;122
58;77;2;66;55;121
58;77;0;66;69;135
58;42;56;65;50;115
58;14;48;65;34;99
58;63;31;65;59;124
58;63;17;65;75;140
58;84;15;65;40;105
58;7;15;65;74;139
58;28;11;65;43;108
58;49;52;64;45;109
58;7;22;64;47;111
58;98;8;64;32;96
58;56;68;63;69;132
58;70;51;63;53;116
58;7;44;63;61;124
58;7;40;63;62;125
58;63;33;63;53;116
58;28;17;63;58;121
58;63;14;63;57;120
58;77;9;63;72;135
58;49;55;62;60;122
58;14;44;62;55;117
58;77;31;62;71;133
58;63;28;62;54;116
58;7;24;62;75;137
58;7;21;62;49;111
58;42;57;61;52;113
58;14;47;61;67;128
58;7;41;61;49;110
58;77;28;61;56;117
58;105;23;61;47;108
58;42;58;60;56;116
58;7;36;60;50;110
58;7;34;60;71;131
58;112;75;59;59;118
58;112;72;59;72;131
58;91;64;59;33;92
58;7;46;59;51;110
58;77;43;59;44;103
58;77;32;59;74;133
58;63;25;59;47;106
58;105;20;59;49;108
58;63;6;59;69;128
58;77;41;58;47;105
58;77;37;58;56;114
58;63;32;58;63;121
58;105;30;58;43;101
58;63;24;58;58;116
58;77;19;58;53;111
58;98;15;58;37;95
58;84;8;58;45;103
58;112;77;57;59;116
58;112;74;57;70;127
58;112;71;57;74;131
58;49;53;57;58;115
58;14;43;57;57;114
58;7;28;57;77;134
58;105;24;57;57;114
58;105;22;57;61;118
58;84;14;57;50;107
58;77;5;57;46;103
58;63;1;57;72;129
58;35;88;56;178;234
58;56;69;56;51;107
58;91;61;56;42;98
58;63;23;56;51;107
58;98;14;56;47;103
58;84;12;56;45;101
58;56;70;55;55;110
58;70;55;55;51;106
58;49;54;55;65;120
58;14;46;55;49;104
58;105;39;55;30;85
58;7;39;55;54;109
58;77;29;55;73;128
58;63;29;55;54;109
58;63;20;55;63;118
58;7;5;55;82;137
58;84;4;55;32;87
58;7;42;54;60;114
58;77;40;54;48;102
58;63;35;54;58;112
58;7;23;54;69;123
58;84;17;54;48;102
58;77;17;54;92;146
58;28;15;54;66;120
58;77;7;54;62;116
58;70;63;53;44;97
58;105;26;53;64;117
58;77;25;53;44;97
58;63;22;53;58;111
58;84;18;53;49;102
58;84;16;53;51;104
58;28;6;53;44;97
58;63;4;53;54;107
58;105;2;53;61;114
58;105;1;53;63;116
58;49;59;52;45;97
58;63;46;52;36;88
58;105;32;52;56;108
58;77;24;52;43;95
58;105;21;52;48;100
58;98;16;52;42;94
58;84;10;52;48;100
58;28;9;52;43;95
58;63;5;52;56;108
58;56;71;51;53;104
58;70;56;51;51;102
58;14;56;51;42;93
58;14;49;51;37;88
58;7;48;51;32;83
58;77;46;51;39;90
58;7;45;51;54;105
58;63;39;51;40;91
58;84;30;51;38;89
58;63;27;51;65;116
58;63;26;51;60;111
58;28;18;51;36;87
58;98;12;51;47;98
58;112;73;50;65;115
58;91;62;50;36;86
58;70;62;50;48;98
58;77;42;50;40;90
58;98;18;50;34;84
58;84;13;50;53;103
58;84;9;50;46;96
58;28;1;50;35;85
58;7;53;49;33;82
58;7;50;49;42;91
58;105;38;49;42;91
58;63;38;49;50;99
58;84;35;49;37;86
58;77;26;49;62;111
58;77;21;49;40;89
58;63;8;49;73;122
58;49;60;48;48;96
58;42;59;48;41;89
58;14;51;48;39;87
58;14;50;48;41;89
58;7;47;48;53;101
58;105;41;48;42;90
58;105;40;48;44;92
58;105;37;48;50;98
58;63;36;48;52;100
58;105;33;48;60;108
58;105;25;48;47;95
58;63;21;48;50;98
58;98;19;48;35;83
58;84;11;48;45;93
58;112;70;47;85;132
58;49;58;47;50;97
58;70;57;47;49;96
58;105;43;47;37;84
58;105;29;47;67;114
58;105;27;47;54;101
58;84;20;47;29;76
58;84;19;47;46;93
58;98;17;47;48;95
58;28;16;47;63;110
58;28;13;47;53;100
58;98;11;47;49;96
58;70;64;46;35;81
58;42;60;46;45;91
58;70;54;46;50;96
58;7;49;46;40;86
58;105;48;46;37;83
58;63;45;46;41;87
58;77;27;46;74;120
58;98;20;46;42;88
58;98;0;46;53;99
58;91;65;45;31;76
58;91;63;45;39;84
58;42;61;45;39;84
58;14;59;45;23;68
58;49;56;45;47;92
58;63;40;45;47;92
58;98;10;45;44;89
58;98;4;45;36;81
58;70;60;44;52;96
58;70;59;44;41;85
58;77;44;44;43;87
58;63;41;44;34;78
58;112;78;43;49;92
58;14;55;43;35;78
58;14;52;43;37;80
58;84;37;43;34;77
58;84;31;43;37;80
58;77;23;43;59;102
58;98;13;43;55;98
58;84;5;43;50;93
58;98;3;43;40;83
58;42;64;42;51;93
58;42;63;42;35;77
58;42;62;42;32;74
58;7;54;42;35;77
58;14;53;42;28;70
58;105;49;42;29;71
58;105;47;42;26;68
58;77;47;42;39;81
58;105;45;42;41;83
58;63;43;42;34;76
58;98;32;42;33;75
58;105;31;42;59;101
58;28;12;42;56;98
58;49;64;41;26;67
58;70;61;41;44;85
58;49;57;41;61;102
58;7;55;41;32;73
58;7;51;41;31;72
58;77;50;41;24;65
58;105;44;41;36;77
58;84;44;41;25;66
58;63;44;41;37;78
58;7;43;41;34;75
58;105;36;41;64;105
58;84;36;41;41;82
58;84;25;41;23;64
58;28;19;41;49;90
58;98;9;41;45;86
58;28;4;41;36;77
58;42;65;40;39;79
58;49;61;40;41;81
58;7;58;40;26;66
58;14;57;40;29;69
58;77;48;40;33;73
58;105;46;40;51;91
58;77;45;40;51;91
58;28;44;40;37;77
58;63;37;40;51;91
58;63;34;40;66;106
58;28;28;40;29;69
58;77;22;40;42;82
58;84;7;40;34;74
58;98;1;40;51;91
58;35;91;39;113;152
58;56;76;39;43;82
58;49;63;39;38;77
58;14;58;39;23;62
58;63;51;39;26;65
58;98;46;39;25;64
58;84;40;39;28;67
58;98;37;39;44;83
58;28;30;39;39;78
58;84;26;39;35;74
58;98;24;39;30;69
58;28;24;39;30;69
58;98;5;39;41;80
58;28;5;39;37;76
58;28;3;39;38;77
58;35;89;38;164;202
58;112;79;38;54;92
58;70;65;38;43;81
58;70;58;38;52;90
58;7;56;38;25;63
58;63;54;38;38;76
58;105;50;38;22;60
58;63;49;38;30;68
58;28;36;38;36;74
58;105;34;38;39;77
58;84;34;38;39;77
58;84;33;38;35;73
58;84;32;38;50;88
58;98;2;38;48;86
58;14;63;37;20;57
58;49;62;37;42;79
58;14;54;37;36;73
58;77;49;37;28;65
58;105;42;37;47;84
58;98;30;37;34;71
58;98;22;37;34;71
58;105;53;36;35;71
58;84;29;36;32;68
58;84;24;36;31;67
58;84;1;36;54;90
58;56;73;35;43;78
58;91;66;35;26;61
58;14;65;35;19;54
58;98;45;35;29;64
58;98;31;35;40;75
58;28;31;35;27;62
58;98;29;35;35;70
58;28;29;35;30;65
58;28;27;35;42;77
58;28;23;35;27;62
58;28;20;35;34;69
58;28;2;35;29;64
58;98;54;34;15;49
58;77;53;34;26;60
58;77;52;34;28;62
58;63;52;34;41;75
58;63;50;34;30;64
58;28;38;34;36;70
58;84;28;34;41;75
58;28;26;34;26;60
58;84;21;34;28;62
58;28;7;34;28;62
58;28;0;34;33;67
58;56;72;33;66;99
58;91;67;33;30;63
58;70;66;33;34;67
58;14;60;33;24;57
58;105;58;33;19;52
58;7;52;33;30;63
58;84;42;33;31;64
58;84;38;33;31;64
58;98;33;33;29;62
58;28;22;33;45;78
58;21;15;33;19;52
58;98;6;33;31;64
58;84;0;33;43;76
58;49;70;32;34;66
58;77;55;32;21;53
58;77;54;32;19;51
58;63;47;32;40;72
58;63;42;32;45;77
58;98;41;32;24;56
58;98;35;32;25;57
58;98;34;32;38;70
58;98;21;32;35;67
58;21;17;32;14;46
58;98;7;32;35;67
58;84;6;32;26;58
58;84;3;32;26;58
58;84;2;32;47;79
58;112;76;31;56;87
58;7;63;31;22;53
58;7;59;31;29;60
58;105;57;31;22;53
58;105;56;31;15;46
58;105;55;31;25;56
58;63;55;31;21;52
58;105;54;31;25;56
58;98;51;31;15;46
58;84;48;31;20;51
58;28;45;31;26;57
58;84;43;31;20;51
58;98;42;31;27;58
58;84;41;31;27;58
58;98;40;31;30;61
58;84;39;31;37;68
58;98;36;31;33;64
58;98;28;31;41;72
58;84;27;31;41;72
58;28;8;31;46;77
58;91;70;30;22;52
58;42;69;30;26;56
58;70;68;30;24;54
58;70;67;30;17;47
58;49;65;30;42;72
58;63;59;30;17;47
58;7;57;30;29;59
58;98;56;30;13;43
58;63;53;30;23;53
58;28;50;30;29;59
58;28;48;30;28;58
58;98;44;30;36;66
58;28;37;30;42;72
58;98;26;30;22;52
58;84;22;30;34;64
58;21;11;30;18;48
58;35;90;29;132;161
58;56;75;29;50;79
58;56;74;29;47;76
58;63;56;29;32;61
58;105;52;29;19;48
58;77;51;29;28;57
58;84;50;29;28;57
58;63;48;29;32;61
58;84;47;29;25;54
58;84;45;29;30;59
58;98;39;29;38;67
58;98;38;29;27;56
58;42;68;28;40;68
58;14;61;28;14;42
58;7;61;28;25;53
58;77;58;28;20;48
58;63;58;28;22;50
58;63;57;28;16;44
58;105;51;28;31;59
58;84;51;28;12;40
58;84;46;28;21;49
58;28;35;28;34;62
58;98;27;28;36;64
58;112;80;27;45;72
58;56;77;27;38;65
58;42;75;27;18;45
58;77;64;27;14;41
58;7;60;27;29;56
58;28;49;27;16;43
58;28;47;27;29;56
58;21;28;27;18;45
58;84;23;27;37;64
58;56;81;26;25;51
58;56;80;26;36;62
58;42;70;26;29;55
58;49;67;26;26;52
58;42;67;26;47;73
58;98;57;26;15;41
58;84;57;26;13;39
58;28;52;26;13;39
58;28;43;26;21;47
58;28;40;26;27;53
58;28;39;26;26;52
58;28;33;26;43;69
58;28;21;26;21;47
58;21;10;26;16;42
58;21;6;26;13;39
58;49;73;25;17;42
58;14;71;25;7;32
58;14;62;25;28;53
58;105;59;25;20;45
58;77;57;25;20;45
58;77;56;25;18;43
58;98;49;25;23;48
58;28;41;25;34;59
58;28;34;25;40;65
58;28;32;25;37;62
58;28;25;25;39;64
58;21;12;25;24;49
58;35;95;24;29;53
58;49;71;24;21;45
58;7;70;24;12;36
58;91;69;24;15;39
58;49;66;24;31;55
58;63;61;24;14;38
58;28;55;24;29;53
58;98;53;24;21;45
58;84;52;24;11;35
58;98;25;24;28;52
58;42;74;23;27;50
58;70;69;23;18;41
58;14;68;23;16;39
58;7;67;23;17;40
58;7;62;23;17;40
58;98;61;23;12;35
58;98;59;23;13;36
58;84;55;23;14;37
58;84;53;23;15;38
58;98;50;23;17;40
58;84;49;23;33;56
58;28;46;23;26;49
58;98;43;23;19;42
58;21;22;23;24;47
58;21;18;23;19;42
58;21;2;23;24;47
58;56;78;22;31;53
58;70;71;22;17;39
58;49;68;22;26;48
58;63;64;22;12;34
58;105;62;22;7;29
58;28;62;22;10;32
58;28;59;22;14;36
58;28;53;22;25;47
58;28;51;22;19;41
58;98;47;22;30;52
58;21;20;22;14;36
58;21;19;22;22;44
58;21;1;22;23;45
58;21;0;22;21;43
58;112;84;21;32;53
58;56;84;21;18;39
58;112;82;21;39;60
58;14;70;21;9;30
58;91;68;21;24;45
58;63;68;21;19;40
58;105;66;21;21;42
58;98;66;21;15;36
58;63;65;21;11;32
58;105;63;21;28;49
58;63;62;21;11;32
58;84;61;21;15;36
58;84;56;21;18;39
58;98;55;21;14;35
58;21;30;21;16;37
58;35;93;20;54;74
58;91;74;20;12;32
58;91;72;20;14;34
58;105;71;20;9;29
58;42;71;20;25;45
58;42;66;20;31;51
58;105;64;20;22;42
58;14;64;20;23;43
58;98;63;20;10;30
58;77;63;20;13;33
58;77;62;20;15;35
58;84;54;20;11;31
58;21;38;20;9;29
58;21;32;20;11;31
58;21;21;20;16;36
58;21;4;20;22;42
58;112;81;19;39;58
58;49;80;19;18;37
58;56;79;19;30;49
58;49;74;19;22;41
58;91;73;19;14;33
58;14;67;19;10;29
58;7;66;19;18;37
58;7;65;19;16;35
58;105;60;19;31;50
58;84;60;19;14;33
58;28;58;19;11;30
58;28;56;19;18;37
58;98;48;19;20;39
58;21;36;19;14;33
58;21;31;19;13;32
58;21;29;19;21;40
58;98;23;19;31;50
58;21;5;19;18;37
58;42;76;18;19;37
58;42;72;18;24;42
58;70;70;18;14;32
58;77;67;18;16;34
58;63;67;18;25;43
58;63;66;18;17;35
58;14;66;18;7;25
58;7;64;18;23;41
58;84;62;18;10;28
58;77;61;18;22;40
58;77;59;18;13;31
58;98;52;18;23;41
58;21;33;18;18;36
58;21;8;18;14;32
58;21;7;18;13;31
58;35;94;17;46;63
58;35;92;17;48;65
58;112;83;17;30;47
58;91;75;17;13;30
58;49;75;17;23;40
58;42;73;17;17;34
58;49;72;17;23;40
58;98;70;17;6;23
58;77;70;17;13;30
58;7;69;17;13;30
58;7;68;17;12;29
58;105;67;17;25;42
58;84;63;17;10;27
58;105;61;17;17;34
58;28;61;17;17;34
58;77;60;17;20;37
58;63;60;17;19;36
58;28;42;17;26;43
58;21;41;17;11;28
58;21;27;17;16;33
58;56;82;16;24;40
58;42;81;16;10;26
58;70;75;16;13;29
58;14;75;16;6;22
58;105;74;16;17;33
58;105;73;16;12;28
58;84;73;16;7;23
58;70;73;16;21;37
58;63;73;16;12;28
58;105;69;16;14;30
58;98;69;16;9;25
58;105;65;16;24;40
58;77;65;16;23;39
58;98;64;16;9;25
58;28;64;16;15;31
58;84;58;16;12;28
58;21;40;16;12;28
58;21;39;16;10;26
58;21;23;16;17;33
58;21;14;16;20;36
58;21;9;16;16;32
58;56;83;15;31;46
58;42;79;15;14;29
58;70;77;15;13;28
58;49;76;15;17;32
58;77;72;15;13;28
58;70;72;15;19;34
58;91;71;15;18;33
58;7;71;15;12;27
58;84;70;15;10;25
58;49;69;15;13;28
58;98;65;15;21;36
58;63;63;15;20;35
58;28;63;15;7;22
58;28;57;15;13;28
58;28;54;15;20;35
58;21;50;15;14;29
58;21;35;15;12;27
58;21;25;15;13;28
58;21;13;15;23;38
58;14;74;14;10;24
58;105;72;14;12;26
58;28;72;14;9;23
58;98;60;14;10;24
58;21;58;14;10;24
58;21;44;14;13;27
58;21;42;14;13;27
58;21;24;14;14;28
58;112;87;13;15;28
58;56;86;13;16;29
58;112;85;13;30;43
58;42;78;13;25;38
58;91;77;13;15;28
58;98;74;13;8;21
58;70;74;13;11;24
58;98;72;13;6;19
58;14;72;13;14;27
58;7;72;13;16;29
58;98;71;13;10;23
58;77;69;13;13;26
58;14;69;13;9;22
58;105;68;13;17;30
58;77;68;13;12;25
58;84;66;13;10;23
58;98;62;13;13;26
58;28;60;13;16;29
58;84;59;13;19;32
58;21;49;13;10;23
58;21;48;13;7;20
58;21;43;13;12;25
58;21;37;13;10;23
58;21;26;13;11;24
58;21;16;13;19;32
58;112;89;12;14;26
58;112;86;12;29;41
58;56;85;12;21;33
58;42;80;12;16;28
58;49;77;12;14;26
58;42;77;12;26;38
58;7;76;12;15;27
58;7;75;12;9;21
58;14;73;12;5;17
58;63;70;12;19;31
58;63;69;12;7;19
58;28;66;12;12;24
58;98;58;12;16;28
58;21;3;12;22;34
58;91;81;11;7;18
58;63;79;11;7;18
58;49;79;11;16;27
58;49;78;11;23;34
58;105;76;11;7;18
58;91;76;11;9;20
58;84;74;11;7;18
58;63;74;11;16;27
58;84;71;11;10;21
58;21;70;11;6;17
58;21;59;11;4;15
58;21;57;11;7;18
58;21;52;11;10;21
58;21;34;11;10;21
58;91;80;10;14;24
58;7;80;10;13;23
58;7;78;10;8;18
58;98;76;10;10;20
58;28;73;10;6;16
58;7;73;10;7;17
58;84;72;10;7;17
58;21;71;10;3;13
58;105;70;10;7;17
58;28;69;10;5;15
58;98;67;10;12;22
58;84;65;10;10;20
58;21;63;10;2;12
58;21;62;10;7;17
58;21;53;10;6;16
58;21;51;10;7;17
58;112;88;9;21;30
58;49;85;9;5;14
58;49;81;9;11;20
58;91;79;9;10;19
58;98;78;9;8;17
58;70;78;9;13;22
58;70;76;9;9;18
58;28;75;9;6;15
58;77;74;9;8;17
58;98;68;9;11;20
58;77;66;9;24;33
58;21;60;9;6;15
58;21;55;9;11;20
58;21;47;9;10;19
58;49;83;8;14;22
58;49;82;8;7;15
58;63;81;8;12;20
58;63;80;8;11;19
58;21;79;8;3;11
58;7;79;8;3;11
58;105;78;8;5;13
58;84;78;8;9;17
58;7;77;8;5;13
58;63;76;8;10;18
58;28;76;8;8;16
58;77;75;8;8;16
58;63;75;8;12;20
58;21;75;8;4;12
58;7;74;8;8;16
58;63;72;8;16;24
58;77;71;8;8;16
58;84;69;8;5;13
58;21;69;8;5;13
58;84;68;8;12;20
58;28;68;8;5;13
58;21;68;8;7;15
58;84;67;8;6;14
58;28;67;8;11;19
58;21;67;8;7;15
58;21;64;8;11;19
58;21;56;8;4;12
58;21;46;8;9;17
58;56;87;7;12;19
58;42;86;7;5;12
58;49;84;7;12;19
58;70;83;7;8;15
58;105;82;7;3;10
58;98;82;7;4;11
58;70;80;7;10;17
58;28;80;7;7;14
58;105;79;7;9;16
58;98;79;7;5;12
58;70;79;7;6;13
58;14;78;7;4;11
58;105;77;7;8;15
58;98;77;7;10;17
58;63;77;7;13;20
58;105;75;7;14;21
58;84;75;7;10;17
58;21;74;7;2;9
58;98;73;7;2;9
58;77;73;7;13;20
58;63;71;7;14;21
58;84;64;7;8;15
58;21;54;7;13;20
58;21;45;7;8;15
58;112;91;6;9;15
58;112;90;6;16;22
58;49;89;6;3;9
58;42;87;6;7;13
58;42;84;6;8;14
58;98;83;6;4;10
58;91;82;6;4;10
58;42;82;6;15;21
58;91;78;6;14;20
58;63;78;6;12;18
58;77;76;6;11;17
58;28;74;6;3;9
58;21;72;6;4;10
58;21;65;6;4;10
58;98;86;5;2;7
58;77;86;5;4;9
58;63;86;5;0;5
58;49;86;5;10;15
58;7;83;5;5;10
58;7;82;5;7;12
58;84;81;5;5;10
58;105;80;5;9;14
58;84;80;5;3;8
58;84;79;5;6;11
58;77;79;5;2;7
58;77;78;5;9;14
58;28;78;5;3;8
58;77;77;5;6;11
58;28;77;5;2;7
58;14;77;5;9;14
58;84;76;5;6;11
58;14;76;5;5;10
58;98;75;5;8;13
58;21;66;5;12;17
58;28;65;5;7;12
58;21;61;5;13;18
58;112;92;4;5;9
58;56;91;4;4;8
58;70;89;4;0;4
58;56;88;4;12;16
58;42;88;4;6;10
58;105;87;4;1;5
58;70;87;4;8;12
58;70;86;4;7;11
58;42;85;4;17;21
58;105;84;4;0;4
58;28;84;4;3;7
58;63;83;4;5;9
58;42;83;4;9;13
58;77;82;4;9;13
58;105;81;4;6;10
58;77;81;4;7;11
58;14;80;4;5;9
58;84;77;4;4;8
58;112;93;3;8;11
58;56;92;3;6;9
58;7;92;3;4;7
58;42;90;3;8;11
58;21;90;3;0;3
58;7;90;3;2;5
58;63;89;3;2;5
58;105;88;3;1;4
58;98;88;3;3;6
58;70;88;3;2;5
58;49;88;3;2;5
58;91;87;3;5;8
58;77;87;3;3;6
58;49;87;3;5;8
58;7;86;3;3;6
58;98;85;3;4;7
58;91;85;3;3;6
58;84;85;3;2;5
58;7;85;3;5;8
58;91;84;3;7;10
58;63;84;3;2;5
58;91;83;3;11;14
58;14;83;3;1;4
58;70;82;3;12;15
58;63;82;3;2;5
58;28;82;3;5;8
58;14;82;3;3;6
58;98;81;3;2;5
58;70;81;3;11;14
58;7;81;3;10;13
58;98;80;3;7;10
58;28;79;3;1;4
58;21;76;3;3;6
58;28;71;3;11;14
58;28;70;3;7;10
58;35;96;2;22;24
58;7;96;2;0;2
58;105;95;2;0;2
58;56;95;2;2;4
58;42;92;2;1;3
58;105;91;2;3;5
58;77;91;2;0;2
58;105;90;2;8;10
58;56;90;2;20;22
58;56;89;2;5;7
58;21;89;2;1;3
58;7;89;2;2;4
58;21;86;2;4;6
58;14;86;2;0;2
58;70;85;2;7;9
58;63;85;2;10;12
58;77;84;2;3;5
58;70;84;2;4;6
58;14;84;2;3;5
58;7;84;2;6;8
58;105;83;2;5;7
58;84;83;2;5;7
58;77;83;2;8;10
58;21;83;2;0;2
58;84;82;2;3;5
58;21;81;2;2;4
58;14;81;2;2;4
58;77;80;2;4;6
58;14;79;2;5;7
58;21;78;2;1;3
58;21;73;2;5;7
58;35;103;1;0;1
58;42;100;1;1;2
58;56;99;1;0;1
58;35;99;1;13;14
58;91;98;1;1;2
58;77;98;1;0;1
58;63;98;1;0;1
58;35;98;1;16;17
58;112;97;1;2;3
58;35;97;1;7;8
58;14;97;1;0;1
58;112;96;1;1;2
58;70;96;1;0;1
58;56;96;1;1;2
58;42;96;1;0;1
58;28;96;1;0;1
58;112;95;1;2;3
58;91;95;1;1;2
58;70;95;1;2;3
58;49;95;1;3;4
58;14;95;1;1;2
58;7;95;1;0;1
58;112;94;1;6;7
58;70;94;1;0;1
58;49;94;1;1;2
58;42;94;1;1;2
58;14;94;1;0;1
58;7;94;1;0;1
58;105;93;1;3;4
58;70;93;1;0;1
58;63;93;1;0;1
58;49;93;1;1;2
58;28;93;1;0;1
58;105;92;1;0;1
58;91;92;1;0;1
58;77;92;1;3;4
58;70;92;1;6;7
58;28;92;1;0;1
58;21;92;1;2;3
58;98;91;1;1;2
58;91;91;1;0;1
58;70;91;1;2;3
58;49;91;1;3;4
58;42;91;1;5;6
58;21;91;1;0;1
58;91;90;1;2;3
58;98;89;1;2;3
58;77;89;1;3;4
58;28;89;1;2;3
58;77;88;1;3;4
58;63;88;1;4;5
58;21;88;1;0;1
58;14;88;1;0;1
58;7;88;1;5;6
58;84;87;1;2;3
58;63;87;1;1;2
58;91;86;1;2;3
58;28;86;1;1;2
58;105;85;1;3;4
58;77;85;1;4;5
58;21;85;1;0;1
58;14;85;1;1;2
58;21;84;1;1;2
58;28;83;1;1;2
58;21;82;1;3;4
58;28;81;1;4;5
58;35;110;0;13;13
58;7;110;0;1;1
58;105;109;0;1;1
58;35;108;0;1;1
58;14;107;0;1;1
58;28;105;0;1;1
58;7;105;0;1;1
58;112;104;0;2;2
58;35;102;0;1;1
58;91;101;0;1;1
58;77;101;0;1;1
58;35;101;0;3;3
58;112;100;0;1;1
58;77;100;0;1;1
58;35;100;0;2;2
58;7;100;0;1;1
58;112;99;0;1;1
58;49;99;0;2;2
58;56;98;0;2;2
58;21;98;0;1;1
58;14;98;0;1;1
58;98;97;0;1;1
58;91;97;0;1;1
58;84;97;0;1;1
58;77;97;0;1;1
58;63;97;0;1;1
58;56;97;0;3;3
58;49;97;0;1;1
58;42;97;0;1;1
58;7;97;0;1;1
58;91;96;0;1;1
58;84;96;0;1;1
58;77;96;0;2;2
58;14;96;0;1;1
58;98;95;0;1;1
58;84;95;0;2;2
58;42;95;0;1;1
58;28;95;0;1;1
58;77;94;0;1;1
58;63;94;0;1;1
58;56;94;0;1;1
58;21;94;0;1;1
58;91;93;0;1;1
58;77;93;0;1;1
58;56;93;0;4;4
58;42;93;0;4;4
58;84;92;0;1;1
58;49;92;0;2;2
58;63;91;0;1;1
58;28;91;0;2;2
58;14;91;0;2;2
58;7;91;0;1;1
58;77;90;0;3;3
58;70;90;0;4;4
58;63;90;0;2;2
58;49;90;0;2;2
58;28;90;0;2;2
58;105;89;0;2;2
58;91;89;0;3;3
58;84;89;0;4;4
58;42;89;0;7;7
58;91;88;0;4;4
58;28;88;0;1;1
58;98;87;0;1;1
58;28;87;0;1;1
58;7;87;0;2;2
58;105;86;0;4;4
58;84;86;0;1;1
58;28;85;0;4;4
58;98;84;0;4;4
58;84;84;0;2;2
58;21;80;0;2;2
58;21;77;0;5;5
66;91;66;1;9;10
66;105;77;1;10;11
66;63;80;1;5;6
66;105;84;1;2;3
66;154;84;1;3;4
66;70;85;1;6;7
66;91;86;1;1;2
66;105;86;1;4;5
66;161;87;1;4;5
66;63;88;1;4;5
66;91;88;1;0;1
66;14;89;1;6;7
66;70;89;1;1;2
66;105;89;1;1;2
66;42;90;1;10;11
66;77;90;1;1;2
66;91;90;1;0;1
66;119;90;1;0;1
66;63;91;1;0;1
66;84;91;1;0;1
66;14;92;1;1;2
66;35;92;1;1;2
66;70;92;1;0;1
66;77;92;1;0;1
66;84;92;1;1;2
66;98;92;1;3;4
66;133;92;1;1;2
66;154;92;1;1;2
66;21;93;1;1;2
66;56;93;1;14;15
66;63;93;1;0;1
66;70;93;1;0;1
66;126;93;1;6;7
66;133;93;1;4;5
66;154;93;1;1;2
66;161;93;1;1;2
66;21;94;1;3;4
66;77;94;1;0;1
66;91;94;1;0;1
66;105;94;1;1;2
66;126;94;1;2;3
66;7;95;1;5;6
66;21;95;1;0;1
66;147;95;1;4;5
66;154;95;1;2;3
66;35;96;1;2;3
66;42;96;1;2;3
66;56;96;1;6;7
66;63;96;1;1;2
66;112;96;1;0;1
66;119;96;1;0;1
66;154;96;1;3;4
66;21;97;1;2;3
66;42;97;1;0;1
66;112;97;1;3;4
66;126;97;1;1;2
66;140;97;1;1;2
66;49;98;1;1;2
66;140;98;1;0;1
66;14;99;1;0;1
66;77;99;1;0;1
66;28;100;1;3;4
66;35;100;1;1;2
66;98;100;1;0;1
66;112;100;1;1;2
66;140;100;1;3;4
66;154;100;1;0;1
66;84;101;1;0;1
66;126;101;1;0;1
66;133;101;1;0;1
66;56;102;1;0;1
66;63;102;1;1;2
66;91;43;2;11;13
66;91;59;2;5;7
66;91;60;2;6;8
66;91;63;2;4;6
66;91;68;2;5;7
66;91;69;2;4;6
66;91;71;2;6;8
66;91;72;2;2;4
66;105;73;2;9;11
66;91;76;2;0;2
66;91;77;2;3;5
66;70;78;2;5;7
66;91;78;2;2;4
66;105;81;2;2;4
66;105;82;2;3;5
66;91;83;2;5;7
66;14;84;2;7;9
66;91;84;2;0;2
66;105;85;2;7;9
66;77;86;2;5;7
66;119;86;2;7;9
66;161;86;2;5;7
66;70;87;2;3;5
66;77;87;2;4;6
66;154;87;2;4;6
66;84;88;2;1;3
66;98;88;2;5;7
66;133;88;2;8;10
66;14;90;2;5;7
66;63;90;2;1;3
66;84;90;2;8;10
66;133;90;2;2;4
66;154;90;2;2;4
66;161;90;2;1;3
66;70;91;2;1;3
66;77;91;2;3;5
66;140;91;2;15;17
66;63;92;2;1;3
66;140;92;2;7;9
66;147;92;2;5;7
66;14;93;2;3;5
66;49;93;2;3;5
66;119;93;2;2;4
66;140;93;2;7;9
66;98;94;2;0;2
66;133;94;2;3;5
66;140;94;2;6;8
66;161;94;2;0;2
66;112;95;2;6;8
66;119;95;2;0;2
66;133;95;2;2;4
66;147;96;2;3;5
66;56;97;2;6;8
66;21;98;2;1;3
66;28;98;2;50;52
66;161;98;2;0;2
66;28;99;2;12;14
66;140;99;2;1;3
66;28;110;2;0;2
66;91;47;3;12;15
66;91;50;3;10;13
66;91;73;3;4;7
66;91;74;3;0;3
66;91;75;3;4;7
66;14;80;3;16;19
66;91;80;3;7;10
66;105;80;3;1;4
66;63;81;3;7;10
66;70;81;3;5;8
66;84;83;3;8;11
66;98;84;3;7;10
66;119;84;3;4;7
66;21;85;3;8;11
66;63;85;3;2;5
66;154;85;3;11;14
66;63;86;3;1;4
66;98;86;3;2;5
66;14;87;3;5;8
66;21;87;3;9;12
66;98;87;3;4;7
66;119;87;3;4;7
66;119;88;3;2;5
66;161;88;3;4;7
66;49;89;3;11;14
66;77;89;3;2;5
66;98;89;3;6;9
66;21;90;3;2;5
66;98;90;3;3;6
66;98;91;3;0;3
66;147;91;3;5;8
66;7;92;3;4;7
66;42;92;3;3;6
66;49;92;3;8;11
66;7;93;3;4;7
66;42;93;3;4;7
66;98;93;3;1;4
66;147;93;3;10;13
66;56;95;3;2;5
66;140;95;3;4;7
66;91;49;4;7;11
66;91;54;4;7;11
66;63;71;4;14;18
66;105;71;4;7;11
66;63;75;4;8;12
66;105;75;4;4;8
66;105;78;4;9;13
66;63;79;4;5;9
66;70;79;4;7;11
66;105;79;4;2;6
66;119;80;4;10;14
66;77;83;4;6;10
66;63;84;4;2;6
66;119;85;4;4;8
66;14;86;4;7;11
66;84;86;4;4;8
66;133;86;4;7;11
66;35;87;4;10;14
66;63;87;4;2;6
66;133;87;4;5;9
66;14;88;4;5;9
66;70;88;4;5;9
66;21;89;4;2;6
66;154;89;4;7;11
66;161;89;4;2;6
66;70;90;4;1;5
66;140;90;4;15;19
66;35;91;4;2;6
66;49;91;4;6;10
66;126;91;4;21;25
66;133;91;4;6;10
66;56;92;4;14;18
66;35;93;4;4;8
66;56;94;4;2;6
66;147;94;4;6;10
66;91;29;5;11;16
66;91;33;5;9;14
66;91;62;5;8;13
66;91;67;5;3;8
66;105;68;5;6;11
66;91;70;5;8;13
66;105;70;5;1;6
66;105;72;5;10;15
66;84;76;5;7;12
66;70;77;5;4;9
66;70;80;5;7;12
66;161;81;5;11;16
66;14;82;5;12;17
66;70;82;5;6;11
66;14;83;5;8;13
66;63;83;5;2;7
66;14;85;5;8;13
66;161;85;5;1;6
66;21;86;5;13;18
66;84;87;5;5;10
66;21;88;5;5;10
66;154;88;5;4;9
66;35;89;5;7;12
66;84;89;5;2;7
66;42;91;5;6;11
66;56;91;5;23;28
66;126;92;5;10;15
66;112;93;5;2;7
66;49;94;5;6;11
66;56;98;5;3;8
66;91;21;6;11;17
66;91;51;6;9;15
66;91;56;6;6;12
66;91;58;6;7;13
66;91;61;6;7;13
66;105;69;6;9;15
66;84;71;6;16;22
66;70;73;6;9;15
66;119;76;6;11;17
66;63;77;6;7;13
66;154;79;6;11;17
66;161;79;6;8;14
66;84;81;6;6;12
66;154;81;6;13;19
66;119;82;6;6;12
66;154;82;6;9;15
66;70;83;6;2;8
66;154;83;6;10;16
66;70;84;6;7;13
66;84;85;6;6;12
66;154;86;6;7;13
66;35;88;6;12;18
66;77;88;6;1;7
66;133;89;6;3;9
66;112;90;6;15;21
66;7;91;6;8;14
66;112;91;6;10;16
66;112;92;6;7;13
66;112;94;6;9;15
66;91;38;7;6;13
66;91;48;7;7;14
66;91;52;7;2;9
66;91;53;7;6;13
66;105;63;7;15;22
66;105;64;7;10;17
66;70;74;7;3;10
66;84;74;7;11;18
66;105;74;7;8;15
66;70;75;7;12;19
66;105;76;7;5;12
66;77;79;7;8;15
66;77;82;7;6;13
66;84;82;7;11;18
66;84;84;7;1;8
66;77;85;7;5;12
66;7;89;7;15;22
66;126;89;7;23;30
66;147;89;7;9;16
66;35;90;7;8;15
66;91;22;8;8;16
66;91;34;8;9;17
66;91;45;8;7;15
66;91;46;8;9;17
66;63;49;8;17;25
66;91;64;8;6;14
66;91;65;8;6;14
66;63;74;8;14;22
66;77;78;8;12;20
66;98;80;8;15;23
66;14;81;8;8;16
66;77;81;8;6;14
66;119;83;8;10;18
66;161;83;8;7;15
66;98;85;8;4;12
66;147;86;8;27;35
66;42;87;8;13;21
66;42;88;8;9;17
66;126;88;8;26;34
66;42;89;8;8;16
66;140;89;8;14;22
66;91;25;9;8;17
66;91;26;9;8;17
66;91;30;9;12;21
66;91;32;9;17;26
66;63;45;9;10;19
66;105;56;9;14;23
66;63;60;9;11;20
66;63;72;9;2;11
66;70;72;9;11;20
66;63;73;9;2;11
66;14;76;9;10;19
66;63;76;9;9;18
66;70;76;9;4;13
66;119;77;9;14;23
66;84;78;9;3;12
66;161;78;9;17;26
66;98;79;9;14;23
66;119;79;9;8;17
66;77;80;9;8;17
66;154;80;9;6;15
66;119;81;9;8;17
66;63;82;9;4;13
66;98;83;9;7;16
66;42;86;9;12;21
66;140;87;9;23;32
66;7;90;9;10;19
66;147;90;9;9;18
66;91;23;10;12;22
66;91;39;10;7;17
66;91;40;10;6;16
66;105;53;10;18;28
66;63;59;10;10;20
66;119;59;10;17;27
66;14;63;10;21;31
66;63;65;10;7;17
66;105;67;10;7;17
66;84;68;10;19;29
66;119;69;10;13;23
66;154;71;10;10;20
66;154;72;10;17;27
66;77;73;10;10;20
66;119;75;10;11;21
66;161;76;10;17;27
66;161;77;10;11;21
66;14;78;10;20;30
66;119;78;10;11;21
66;84;80;10;8;18
66;21;82;10;8;18
66;98;82;10;4;14
66;161;82;10;10;20
66;161;84;10;7;17
66;49;88;10;17;27
66;147;88;10;19;29
66;28;101;10;10;20
66;91;24;11;8;19
66;91;27;11;13;24
66;91;31;11;9;20
66;91;37;11;6;17
66;70;55;11;21;32
66;91;57;11;6;17
66;105;58;11;15;26
66;63;63;11;11;22
66;119;64;11;17;28
66;119;67;11;12;23
66;154;69;11;15;26
66;70;70;11;20;31
66;14;71;11;18;29
66;84;73;11;15;26
66;14;74;11;7;18
66;119;74;11;16;27
66;77;77;11;12;23
66;98;81;11;15;26
66;21;83;11;14;25
66;21;84;11;12;23
66;133;85;11;14;25
66;35;86;11;14;25
66;140;88;11;13;24
66;56;89;11;34;45
66;112;89;11;24;35
66;28;96;11;51;62
66;91;35;12;12;24
66;91;36;12;12;24
66;63;39;12;27;39
66;91;42;12;4;16
66;63;43;12;11;23
66;119;51;12;16;28
66;91;55;12;10;22
66;119;55;12;23;35
66;105;61;12;14;26
66;84;63;12;15;27
66;63;64;12;13;25
66;70;65;12;10;22
66;105;65;12;10;22
66;70;66;12;17;29
66;84;69;12;19;31
66;14;72;12;15;27
66;77;72;12;13;25
66;77;74;12;15;27
66;14;75;12;10;22
66;77;75;12;7;19
66;21;77;12;23;35
66;63;78;12;2;14
66;154;78;12;9;21
66;14;79;12;12;24
66;21;79;12;15;27
66;84;79;12;18;30
66;21;81;12;12;24
66;35;84;12;19;31
66;35;85;12;25;37
66;91;28;13;15;28
66;91;44;13;8;21
66;63;55;13;9;22
66;105;62;13;8;21
66;119;63;13;20;33
66;154;66;13;23;36
66;63;68;13;8;21
66;119;68;13;15;28
66;14;69;13;22;35
66;70;71;13;9;22
66;119;72;13;14;27
66;84;75;13;8;21
66;84;77;13;15;28
66;133;81;13;19;32
66;42;84;13;16;29
66;140;86;13;19;32
66;49;90;13;11;24
66;91;16;14;16;30
66;91;20;14;16;30
66;91;41;14;7;21
66;70;59;14;10;24
66;105;59;14;9;23
66;105;60;14;10;24
66;63;62;14;5;19
66;161;64;14;27;41
66;63;66;14;9;23
66;119;66;14;22;36
66;63;70;14;9;23
66;14;73;14;12;26
66;154;74;14;9;23
66;154;75;14;16;30
66;14;77;14;14;28
66;98;78;14;17;31
66;133;84;14;8;22
66;7;88;14;11;25
66;91;19;15;16;31
66;63;50;15;18;33
66;63;52;15;9;24
66;105;55;15;16;31
66;63;56;15;17;32
66;119;56;15;20;35
66;70;58;15;18;33
66;119;58;15;27;42
66;154;58;15;27;42
66;84;66;15;15;30
66;63;67;15;9;24
66;63;69;15;6;21
66;84;70;15;12;27
66;119;71;15;8;23
66;161;71;15;21;36
66;119;73;15;15;30
66;161;74;15;18;33
66;35;82;15;12;27
66;133;82;15;13;28
66;7;87;15;19;34
66;126;87;15;16;31
66;147;87;15;19;34
66;28;95;15;36;51
66;63;26;16;23;39
66;105;51;16;24;40
66;63;53;16;14;30
66;119;53;16;21;37
66;119;54;16;20;36
66;105;66;16;16;32
66;84;67;16;18;34
66;70;69;16;9;25
66;84;72;16;9;25
66;154;73;16;14;30
66;98;76;16;9;25
66;21;78;16;20;36
66;21;80;16;25;41
66;161;80;16;20;36
66;42;81;16;19;35
66;49;87;16;28;44
66;63;31;17;17;34
66;63;34;17;21;38
66;63;35;17;20;37
66;105;49;17;17;34
66;63;51;17;17;34
66;63;54;17;11;28
66;105;54;17;22;39
66;119;60;17;23;40
66;63;61;17;9;26
66;77;71;17;8;25
66;161;75;17;16;33
66;77;76;17;8;25
66;154;76;17;13;30
66;133;79;17;25;42
66;91;2;18;20;38
66;63;5;18;28;46
66;63;30;18;17;35
66;119;39;18;21;39
66;63;41;18;13;31
66;63;44;18;11;29
66;70;46;18;17;35
66;119;48;18;23;41
66;70;51;18;31;49
66;14;56;18;31;49
66;63;57;18;12;30
66;119;57;18;20;38
66;84;59;18;18;36
66;70;62;18;19;37
66;70;64;18;19;37
66;70;67;18;10;28
66;77;70;18;18;36
66;119;70;18;21;39
66;161;73;18;21;39
66;98;74;18;11;29
66;98;75;18;20;38
66;154;77;18;13;31
66;133;83;18;11;29
66;147;84;18;27;45
66;42;85;18;12;30
66;147;85;18;24;42
66;112;88;18;22;40
66;91;4;19;22;41
66;63;24;19;17;36
66;63;33;19;26;45
66;63;38;19;14;33
66;63;40;19;12;31
66;119;42;19;30;49
66;84;43;19;24;43
66;119;52;19;17;36
66;70;63;19;21;40
66;119;65;19;18;37
66;14;66;19;26;45
66;77;69;19;8;27
66;98;69;19;19;38
66;161;72;19;22;41
66;42;82;19;21;40
66;112;87;19;28;47
66;91;3;20;19;39
66;91;5;20;25;45
66;91;12;20;22;42
66;91;13;20;24;44
66;70;42;20;33;53
66;119;45;20;21;41
66;119;46;20;26;46
66;119;49;20;24;44
66;84;52;20;18;38
66;105;52;20;15;35
66;70;57;20;14;34
66;14;60;20;30;50
66;119;61;20;19;39
66;161;63;20;35;55
66;98;64;20;26;46
66;14;68;20;21;41
66;161;69;20;19;39
66;21;76;20;22;42
66;98;77;20;11;31
66;112;86;20;31;51
66;28;102;20;0;20
66;63;7;21;31;52
66;91;7;21;26;47
66;91;18;21;15;36
66;63;20;21;24;45
66;63;22;21;19;40
66;63;27;21;19;40
66;63;28;21;16;37
66;63;46;21;10;31
66;70;47;21;26;47
66;119;47;21;17;38
66;63;48;21;13;34
66;70;49;21;25;46
66;119;50;21;13;34
66;154;53;21;23;44
66;70;54;21;29;50
66;98;56;21;21;42
66;105;57;21;14;35
66;70;61;21;22;43
66;84;61;21;22;43
66;154;61;21;18;39
66;119;62;21;11;32
66;154;64;21;22;43
66;84;65;21;16;37
66;42;80;21;30;51
66;147;82;21;34;55
66;35;83;21;19;40
66;140;83;21;28;49
66;7;84;21;39;60
66;126;90;21;16;37
66;91;1;22;18;40
66;91;10;22;27;49
66;91;14;22;22;44
66;119;22;22;39;61
66;63;25;22;21;43
66;63;29;22;24;46
66;14;55;22;28;50
66;154;57;22;22;44
66;161;59;22;26;48
66;84;60;22;24;46
66;77;61;22;30;52
66;154;63;22;34;56
66;14;65;22;24;46
66;77;66;22;16;38
66;70;68;22;14;36
66;98;71;22;18;40
66;35;80;22;34;56
66;35;81;22;18;40
66;147;83;22;20;42
66;7;85;22;23;45
66;112;85;22;39;61
66;126;85;22;40;62
66;140;85;22;26;48
66;7;86;22;19;41
66;63;2;23;31;54
66;63;4;23;27;50
66;91;15;23;28;51
66;63;21;23;28;51
66;70;37;23;26;49
66;119;41;23;20;43
66;98;43;23;31;54
66;63;47;23;15;38
66;14;52;23;48;71
66;70;56;23;40;63
66;154;62;23;24;47
66;77;63;23;29;52
66;14;64;23;22;45
66;77;67;23;19;42
66;98;68;23;15;38
66;154;68;23;22;45
66;98;70;23;17;40
66;133;77;23;34;57
66;49;85;23;22;45
66;91;8;24;17;41
66;119;33;24;33;57
66;70;36;24;38;62
66;63;37;24;17;41
66;70;39;24;19;43
66;70;45;24;25;49
66;98;45;24;44;68
66;70;53;24;34;58
66;98;53;24;37;61
66;14;58;24;26;50
66;77;59;24;32;56
66;14;62;24;19;43
66;98;63;24;24;48
66;84;64;24;13;37
66;154;65;24;14;38
66;14;67;24;17;41
66;21;75;24;28;52
66;140;82;24;35;59
66;42;83;24;12;36
66;91;0;25;18;43
66;70;40;25;28;53
66;84;42;25;34;59
66;70;43;25;17;42
66;119;44;25;32;57
66;70;50;25;16;41
66;84;55;25;23;48
66;63;58;25;9;34
66;154;59;25;20;45
66;70;60;25;23;48
66;77;64;25;15;40
66;154;67;25;14;39
66;21;73;25;30;55
66;49;86;25;18;43
66;28;94;25;131;156
66;91;11;26;32;58
66;63;19;26;26;52
66;119;29;26;37;63
66;70;33;26;31;57
66;70;38;26;23;49
66;119;38;26;30;56
66;70;41;26;27;53
66;63;42;26;11;37
66;105;42;26;17;43
66;154;50;26;36;62
66;14;51;26;28;54
66;70;52;26;19;45
66;154;56;26;26;52
66;98;61;26;21;47
66;98;67;26;20;46
66;77;68;26;19;45
66;161;68;26;26;52
66;133;76;26;36;62
66;42;79;26;34;60
66;140;81;26;38;64
66;140;84;26;30;56
66;56;90;26;34;60
66;91;17;27;16;43
66;119;36;27;31;58
66;119;43;27;24;51
66;154;43;27;30;57
66;84;45;27;34;61
66;105;46;27;26;53
66;84;47;27;20;47
66;14;48;27;35;62
66;84;53;27;19;46
66;161;55;27;38;65
66;84;57;27;20;47
66;14;70;27;14;41
66;21;72;27;27;54
66;42;78;27;22;49
66;133;80;27;25;52
66;7;82;27;41;68
66;7;83;27;32;59
66;63;0;28;38;66
66;63;3;28;27;55
66;63;10;28;39;67
66;63;18;28;33;61
66;70;24;28;43;71
66;63;32;28;22;50
66;105;44;28;27;55
66;105;48;28;13;41
66;161;58;28;35;63
66;14;59;28;25;53
66;98;59;28;29;57
66;98;60;28;30;58
66;154;60;28;25;53
66;21;71;28;31;59
66;56;87;28;67;95
66;56;88;28;31;59
66;63;1;29;25;54
66;63;6;29;38;67
66;91;6;29;22;51
66;91;9;29;22;51
66;70;32;29;38;67
66;63;36;29;30;59
66;105;38;29;31;60
66;98;42;29;33;62
66;70;44;29;27;56
66;98;46;29;30;59
66;77;51;29;38;67
66;77;52;29;33;62
66;98;54;29;30;59
66;161;54;29;42;71
66;154;55;29;23;52
66;84;56;29;20;49
66;77;65;29;16;45
66;98;65;29;15;44
66;161;66;29;26;55
66;21;68;29;39;68
66;21;70;29;36;65
66;98;72;29;17;46
66;98;73;29;11;40
66;35;79;29;29;58
66;49;84;29;41;70
66;63;23;30;18;48
66;84;29;30;42;72
66;84;30;30;39;69
66;70;31;30;29;59
66;84;36;30;28;58
66;154;38;30;41;71
66;14;40;30;40;70
66;84;40;30;30;60
66;84;41;30;34;64
66;84;44;30;27;57
66;84;46;30;23;53
66;70;48;30;36;66
66;98;49;30;40;70
66;98;50;30;37;67
66;105;50;30;22;52
66;84;51;30;25;55
66;154;51;30;30;60
66;14;57;30;30;60
66;77;57;30;32;62
66;77;60;30;37;67
66;14;61;30;27;57
66;98;62;30;21;51
66;21;66;30;38;68
66;133;78;30;20;50
66;70;27;31;33;64
66;154;32;31;51;82
66;105;39;31;21;52
66;154;39;31;34;65
66;14;43;31;29;60
66;105;47;31;24;55
66;84;48;31;26;57
66;14;50;31;25;56
66;84;50;31;20;51
66;161;53;31;44;75
66;84;54;31;26;57
66;77;56;31;30;61
66;161;70;31;29;60
66;42;74;31;42;73
66;49;83;31;36;67
66;28;97;31;32;63
66;63;8;32;35;67
66;70;20;32;55;87
66;119;24;32;24;56
66;119;25;32;35;67
66;119;26;32;29;61
66;119;27;32;35;67
66;70;35;32;28;60
66;84;39;32;26;58
66;119;40;32;36;68
66;105;41;32;40;72
66;105;43;32;18;50
66;14;47;32;26;58
66;77;50;32;41;73
66;154;52;32;28;60
66;161;56;32;38;70
66;77;62;32;36;68
66;84;62;32;24;56
66;98;66;32;28;60
66;161;67;32;31;63
66;21;74;32;25;57
66;42;76;32;32;64
66;35;77;32;35;67
66;119;23;33;28;61
66;70;30;33;34;67
66;119;30;33;29;62
66;84;31;33;44;77
66;119;32;33;40;73
66;84;35;33;35;68
66;105;37;33;31;64
66;119;37;33;29;62
66;98;41;33;32;65
66;98;48;33;32;65
66;161;51;33;37;70
66;154;54;33;28;61
66;161;57;33;33;66
66;98;58;33;33;66
66;161;61;33;27;60
66;161;65;33;33;66
66;49;80;33;50;83
66;63;16;34;41;75
66;119;34;34;40;74
66;14;45;34;30;64
66;154;45;34;35;69
66;154;46;34;36;70
66;154;48;34;34;68
66;154;49;34;28;62
66;161;60;34;26;60
66;21;65;34;45;79
66;126;82;34;56;90
66;28;90;34;146;180
66;28;91;34;116;150
66;119;21;35;27;62
66;84;25;35;37;72
66;161;28;35;61;96
66;70;34;35;33;68
66;154;37;35;38;73
66;84;38;35;34;69
66;98;39;35;40;75
66;154;41;35;36;71
66;77;43;35;30;65
66;14;49;35;21;56
66;14;53;35;19;54
66;84;58;35;24;59
66;21;63;35;40;75
66;21;69;35;29;64
66;154;70;35;19;54
66;49;82;35;41;76
66;84;24;36;36;72
66;119;28;36;35;71
66;154;31;36;45;81
66;119;35;36;27;63
66;154;35;36;54;90
66;161;37;36;50;86
66;77;41;36;39;75
66;98;51;36;32;68
66;77;53;36;38;74
66;21;67;36;42;78
66;133;75;36;40;76
66;140;80;36;54;90
66;70;22;37;46;83
66;14;26;37;40;77
66;70;26;37;44;81
66;154;26;37;49;86
66;14;29;37;58;95
66;70;29;37;48;85
66;14;42;37;27;64
66;161;42;37;50;87
66;105;45;37;15;52
66;77;48;37;24;61
66;98;52;37;34;71
66;42;69;37;40;77
66;133;74;37;32;69
66;140;77;37;58;95
66;7;81;37;42;79
66;112;84;37;52;89
66;56;85;37;104;141
66;63;12;38;42;80
66;63;17;38;35;73
66;84;22;38;46;84
66;14;32;38;48;86
66;84;32;38;31;69
66;77;45;38;41;79
66;14;54;38;27;65
66;77;54;38;32;70
66;112;83;38;40;78
66;63;13;39;38;77
66;84;21;39;40;79
66;70;23;39;35;74
66;161;30;39;64;103
66;119;31;39;41;80
66;154;40;39;36;75
66;84;49;39;20;59
66;42;71;39;52;91
66;42;77;39;38;77
66;63;15;40;39;79
66;70;25;40;40;80
66;84;26;40;33;73
66;161;27;40;59;99
66;154;34;40;54;94
66;154;36;40;32;72
66;14;39;40;43;83
66;161;39;40;52;92
66;161;40;40;50;90
66;154;42;40;27;67
66;161;47;40;36;76
66;77;58;40;24;64
66;161;62;40;24;64
66;35;76;40;44;84
66;147;81;40;37;77
66;126;83;40;76;116
66;70;21;41;39;80
66;14;41;41;42;83
66;14;46;41;34;75
66;21;56;41;78;119
66;21;62;41;44;85
66;35;74;41;43;84
66;49;81;41;47;88
66;126;84;41;66;107
66;14;25;42;49;91
66;154;28;42;40;82
66;14;31;42;54;96
66;105;32;42;33;75
66;105;36;42;41;83
66;14;44;42;42;84
66;77;47;42;45;87
66;154;47;42;25;67
66;77;55;42;24;66
66;42;73;42;35;77
66;147;80;42;53;95
66;14;21;43;38;81
66;105;35;43;41;84
66;77;36;43;56;99
66;161;38;43;44;87
66;105;40;43;38;81
66;154;44;43;35;78
66;21;59;43;49;92
66;112;82;43;65;108
66;63;14;44;36;80
66;154;24;44;49;93
66;84;27;44;31;75
66;105;34;44;34;78
66;14;35;44;40;84
66;161;35;44;53;97
66;84;37;44;23;67
66;77;44;44;37;81
66;161;48;44;39;83
66;161;52;44;37;81
66;133;69;44;57;101
66;42;75;44;35;79
66;140;76;44;48;92
66;140;78;44;50;94
66;84;2;45;49;94
66;63;9;45;33;78
66;63;11;45;43;88
66;98;23;45;63;108
66;105;33;45;40;85
66;14;36;45;44;89
66;98;36;45;35;80
66;98;44;45;28;73
66;161;44;45;57;102
66;98;47;45;19;64
66;98;55;45;33;78
66;7;79;45;41;86
66;140;79;45;64;109
66;14;20;46;51;97
66;154;21;46;44;90
66;98;22;46;72;118
66;84;23;46;38;84
66;154;23;46;51;97
66;161;26;46;65;111
66;70;28;46;48;94
66;161;29;46;73;119
66;98;32;46;47;93
66;161;50;46;42;88
66;98;57;46;34;80
66;147;77;46;62;108
66;56;84;46;94;140
66;28;93;46;219;265
66;84;20;47;33;80
66;119;20;47;43;90
66;77;26;47;60;107
66;14;27;47;39;86
66;105;31;47;32;79
66;14;38;47;36;83
66;77;40;47;49;96
66;77;46;47;42;89
66;133;72;47;29;76
66;35;78;47;50;97
66;98;26;48;60;108
66;77;33;48;59;107
66;84;33;48;39;87
66;14;34;48;43;91
66;98;35;48;37;85
66;98;37;48;37;85
66;77;42;48;58;106
66;161;46;48;40;88
66;42;72;48;37;85
66;133;73;48;36;84
66;112;81;48;50;98
66;84;0;49;56;105
66;14;22;49;40;89
66;14;24;49;35;84
66;105;26;49;61;110
66;105;27;49;42;91
66;84;28;49;42;91
66;77;30;49;71;120
66;84;34;49;30;79
66;98;34;49;47;96
66;35;68;49;67;116
66;140;74;49;62;111
66;119;2;50;56;106
66;154;33;50;39;89
66;98;38;50;45;95
66;77;39;50;56;106
66;98;40;50;37;87
66;21;55;50;68;118
66;35;75;50;37;87
66;84;19;51;46;97
66;98;20;51;68;119
66;105;20;51;51;102
66;154;22;51;45;96
66;77;29;51;62;113
66;105;29;51;43;94
66;154;29;51;55;106
66;98;31;51;48;99
66;14;37;51;46;97
66;161;41;51;45;96
66;21;61;51;52;103
66;35;72;51;65;116
66;56;86;51;62;113
66;126;86;51;19;70
66;105;23;52;49;101
66;154;25;52;46;98
66;154;27;52;46;98
66;14;28;52;46;98
66;98;28;52;68;120
66;98;33;52;68;120
66;77;37;52;53;105
66;161;45;52;56;108
66;147;76;52;50;102
66;112;80;52;79;131
66;84;1;53;53;106
66;98;21;53;53;106
66;105;22;53;36;89
66;161;23;53;69;122
66;77;25;53;62;115
66;105;25;53;47;100
66;98;27;53;51;104
66;42;68;53;49;102
66;35;71;53;54;107
66;14;3;54;61;115
66;84;15;54;61;115
66;70;19;54;43;97
66;77;20;54;63;117
66;105;21;54;38;92
66;161;21;54;53;107
66;98;29;54;64;118
66;161;34;54;60;114
66;21;49;54;56;110
66;161;49;54;54;108
66;21;60;54;56;110
66;42;70;54;45;99
66;119;3;55;59;114
66;84;4;55;46;101
66;154;20;55;47;102
66;161;31;55;65;120
66;161;43;55;43;98
66;77;49;55;37;92
66;21;57;55;62;117
66;21;58;55;51;106
66;49;79;55;64;119
66;28;92;55;132;187
66;105;18;56;60;116
66;119;18;56;58;114
66;21;64;56;42;98
66;133;68;56;47;103
66;49;77;56;68;124
66;105;3;57;79;136
66;84;17;57;73;130
66;14;30;57;59;116
66;161;33;57;48;105
66;35;70;57;54;111
66;133;71;57;43;100
66;119;1;58;57;115
66;70;3;58;72;130
66;84;3;58;61;119
66;70;18;58;62;120
66;84;18;58;61;119
66;105;19;58;56;114
66;77;21;58;51;109
66;14;23;58;50;108
66;77;24;58;62;120
66;98;24;58;51;109
66;161;24;58;58;116
66;77;35;58;69;127
66;161;36;58;53;111
66;42;61;58;75;133
66;35;69;58;51;109
66;140;75;58;56;114
66;126;81;58;95;153
66;119;19;59;49;108
66;98;30;59;53;112
66;21;51;59;64;123
66;42;67;59;57;116
66;133;67;59;53;112
66;140;71;59;78;137
66;98;2;60;72;132
66;98;3;60;68;128
66;98;25;60;57;117
66;161;32;60;53;113
66;35;73;60;53;113
66;147;78;60;64;124
66;7;80;60;62;122
66;14;1;61;68;129
66;98;4;61;77;138
66;161;25;61;63;124
66;21;44;61;86;147
66;133;70;61;48;109
66;84;6;62;63;125
66;161;22;62;63;125
66;105;30;62;45;107
66;77;38;62;45;107
66;42;65;62;48;110
66;105;16;63;69;132
66;105;28;63;39;102
66;14;33;63;41;104
66;147;73;63;55;118
66;49;78;63;64;127
66;98;0;64;78;142
66;14;2;64;78;142
66;154;9;64;77;141
66;154;19;64;62;126
66;21;52;64;63;127
66;42;64;64;65;129
66;7;76;64;69;133
66;112;78;64;75;139
66;147;79;64;49;113
66;70;5;65;75;140
66;84;5;65;56;121
66;70;7;65;73;138
66;84;11;65;73;138
66;84;16;65;56;121
66;7;77;65;55;120
66;98;1;66;78;144
66;70;4;66;68;134
66;84;7;66;62;128
66;98;7;66;82;148
66;119;9;66;81;147
66;77;13;66;69;135
66;105;24;66;53;119
66;21;53;66;64;130
66;35;67;66;57;123
66;140;72;66;59;125
66;112;79;66;64;130
66;119;4;67;74;141
66;77;8;67;103;170
66;77;23;67;51;118
66;140;65;67;98;165
66;147;75;67;71;138
66;77;1;68;59;127
66;77;4;68;71;139
66;119;5;68;66;134
66;119;7;68;63;131
66;77;27;68;53;121
66;77;28;68;59;127
66;77;31;68;81;149
66;77;32;68;59;127
66;77;34;68;74;142
66;133;63;68;70;138
66;56;83;68;89;157
66;70;1;69;76;145
66;14;4;69;60;129
66;77;22;69;62;131
66;133;64;69;47;116
66;147;74;69;69;138
66;7;78;69;49;118
66;70;0;70;71;141
66;77;2;70;83;153
66;105;7;70;62;132
66;154;7;70;80;150
66;84;8;70;79;149
66;105;11;70;76;146
66;154;30;70;45;115
66;42;55;70;85;155
66;42;58;70;71;141
66;133;65;70;57;127
66;42;66;70;53;123
66;112;71;70;86;156
66;98;6;71;65;136
66;119;8;71;73;144
66;84;9;71;63;134
66;84;10;71;70;141
66;98;19;71;60;131
66;84;13;72;65;137
66;70;17;72;65;137
66;21;46;72;87;159
66;21;47;72;72;144
66;21;48;72;85;157
66;42;51;72;77;149
66;42;63;72;56;128
66;140;70;72;79;151
66;147;72;72;78;150
66;112;74;72;83;155
66;49;76;72;67;139
66;77;0;73;68;141
66;77;5;73;78;151
66;98;16;73;94;167
66;119;17;73;63;136
66;14;19;73;54;127
66;21;50;73;75;148
66;21;54;73;66;139
66;112;76;73;80;153
66;56;82;73;80;153
66;105;0;74;75;149
66;154;1;74;68;142
66;98;18;74;74;148
66;119;0;75;69;144
66;154;3;75;74;149
66;105;8;75;80;155
66;119;10;75;89;164
66;161;20;75;73;148
66;21;41;75;79;154
66;140;73;75;59;134
66;154;4;76;74;150
66;77;14;76;67;143
66;14;17;76;70;146
66;105;17;76;69;145
66;154;18;76;63;139
66;133;61;76;65;141
66;119;6;77;77;154
66;154;16;77;91;168
66;21;39;77;98;175
66;42;60;77;81;158
66;133;66;77;51;128
66;147;70;77;90;167
66;49;74;77;108;185
66;105;1;78;72;150
66;70;6;78;76;154
66;70;9;78;90;168
66;70;12;78;90;168
66;119;12;78;87;165
66;154;13;78;80;158
66;21;42;78;62;140
66;42;59;78;71;149
66;154;8;79;75;154
66;70;13;79;90;169
66;98;15;79;81;160
66;105;15;79;69;148
66;77;18;79;62;141
66;140;69;79;67;146
66;70;2;80;85;165
66;154;2;80;83;163
66;77;3;80;81;161
66;98;5;80;73;153
66;105;9;80;91;171
66;84;14;80;53;133
66;42;49;80;82;162
66;42;56;80;67;147
66;147;67;80;103;183
66;14;6;81;71;152
66;98;11;81;86;167
66;70;14;81;104;185
66;98;14;81;89;170
66;154;17;81;66;147
66;21;43;81;92;173
66;133;62;81;61;142
66;105;2;82;80;162
66;70;16;82;80;162
66;77;17;82;58;140
66;42;62;82;74;156
66;35;66;82;47;129
66;112;75;82;86;168
66;105;5;83;69;152
66;84;12;83;62;145
66;77;16;83;60;143
66;21;45;83;62;145
66;42;52;83;74;157
66;112;77;83;94;177
66;126;80;83;131;214
66;14;0;84;77;161
66;77;6;84;59;143
66;77;9;84;69;153
66;119;14;84;69;153
66;70;15;84;86;170
66;77;19;84;67;151
66;161;19;84;70;154
66;42;53;84;67;151
66;42;47;85;75;160
66;42;54;85;79;164
66;42;57;85;92;177
66;133;58;85;74;159
66;133;60;85;91;176
66;35;64;85;96;181
66;140;67;85;88;173
66;147;68;85;84;169
66;98;8;86;91;177
66;105;14;86;94;180
66;42;50;86;88;174
66;35;65;86;97;183
66;7;75;86;71;157
66;105;10;87;92;179
66;77;11;87;87;174
66;119;11;87;75;162
66;98;12;87;79;166
66;154;0;88;74;162
66;105;6;88;74;162
66;42;44;88;106;194
66;140;64;88;117;205
66;154;6;89;79;168
66;98;9;89;88;177
66;154;10;89;98;187
66;105;13;89;73;162
66;112;72;89;92;181
66;49;75;89;87;176
66;154;14;90;84;174
66;98;17;90;71;161
66;21;36;90;103;193
66;42;46;90;105;195
66;133;57;90;63;153
66;14;5;91;70;161
66;77;10;91;86;177
66;154;12;91;93;184
66;98;13;91;74;165
66;154;15;91;90;181
66;21;26;91;114;205
66;21;38;91;95;186
66;7;69;91;90;181
66;70;10;92;85;177
66;21;37;92;88;180
66;105;4;93;73;166
66;14;9;93;89;182
66;77;12;93;79;172
66;14;18;93;61;154
66;42;45;93;68;161
66;42;48;93;83;176
66;35;62;93;104;197
66;147;71;93;71;164
66;7;74;93;73;166
66;147;66;94;107;201
66;147;69;94;102;196
66;49;72;94;95;189
66;14;8;95;92;187
66;119;15;95;76;171
66;140;66;95;97;192
66;154;5;96;65;161
66;154;11;96;82;178
66;112;67;96;125;221
66;112;73;96;96;192
66;56;81;96;91;187
66;98;10;97;75;172
66;14;13;97;99;196
66;21;29;97;130;227
66;35;59;97;92;189
66;7;73;97;89;186
66;14;10;98;109;207
66;14;14;98;84;182
66;77;15;98;90;188
66;133;51;98;98;196
66;35;61;98;91;189
66;140;63;99;85;184
66;49;69;99;119;218
66;7;72;99;72;171
66;49;73;99;72;171
66;119;13;100;89;189
66;56;78;100;165;265
66;119;16;101;72;173
66;35;51;101;139;240
66;133;56;101;77;178
66;105;12;102;99;201
66;21;40;102;84;186
66;133;55;102;71;173
66;133;59;102;68;170
66;35;63;102;85;187
66;112;70;102;123;225
66;126;76;102;119;221
66;77;7;103;76;179
66;14;16;103;96;199
66;42;40;103;133;236
66;112;69;104;97;201
66;49;67;105;128;233
66;70;8;106;84;190
66;133;52;106;83;189
66;133;53;106;85;191
66;140;68;107;59;166
66;14;15;108;83;191
66;21;33;108;117;225
66;42;42;108;111;219
66;147;62;108;114;222
66;147;65;108;92;200
66;49;71;108;102;210
66;70;11;109;84;193
66;7;67;109;116;225
66;56;80;109;173;282
66;21;34;110;106;216
66;42;41;110;99;209
66;133;54;110;75;185
66;147;64;110;93;203
66;49;68;110;119;229
66;7;71;110;86;196
66;161;1;111;116;227
66;14;7;111;92;203
66;14;12;111;93;204
66;21;32;111;112;223
66;56;79;111;126;237
66;161;3;112;116;228
66;161;18;112;106;218
66;21;21;112;107;219
66;21;35;112;107;219
66;42;43;112;92;204
66;49;65;114;159;273
66;42;38;115;133;248
66;7;65;115;102;217
66;49;66;115;134;249
66;14;11;116;118;234
66;133;41;116;118;234
66;112;63;116;142;258
66;140;57;117;146;263
66;21;24;118;130;248
66;140;52;118;137;255
66;35;54;118;147;265
66;140;56;118;119;237
66;140;62;118;119;237
66;56;77;118;185;303
66;161;8;119;143;262
66;161;17;119;116;235
66;140;61;119;115;234
66;147;63;119;114;233
66;126;79;119;140;259
66;161;0;120;129;249
66;140;59;120;135;255
66;7;70;120;108;228
66;28;89;120;236;356
66;112;68;121;132;253
66;21;20;122;121;243
66;42;39;122;110;232
66;35;56;122;134;256
66;35;57;122;122;244
66;35;58;122;126;248
66;49;70;122;114;236
66;112;66;124;122;246
66;56;76;124;161;285
66;21;31;125;112;237
66;42;36;125;133;258
66;140;36;125;177;302
66;147;59;125;113;238
66;28;87;125;260;385
66;161;13;126;165;291
66;133;47;126;103;229
66;161;4;127;121;248
66;21;25;127;126;253
66;133;49;127;90;217
66;35;60;127;101;228
66;49;63;127;156;283
66;21;19;128;131;259
66;21;28;129;112;241
66;133;50;129;96;225
66;112;62;129;140;269
66;7;68;129;109;238
66;21;23;130;145;275
66;133;43;130;134;264
66;49;61;130;148;278
66;42;37;131;121;252
66;35;50;131;141;272
66;147;52;131;155;286
66;112;64;132;120;252
66;161;16;133;154;287
66;21;27;133;118;251
66;133;48;133;131;264
66;35;52;133;137;270
66;147;61;134;130;264
66;112;65;134;120;254
66;161;7;135;123;258
66;21;22;135;113;248
66;147;60;135;134;269
66;35;53;136;104;240
66;126;75;136;132;268
66;21;0;137;161;298
66;161;6;137;160;297
66;21;7;137;144;281
66;161;2;138;115;253
66;42;33;138;146;284
66;133;42;138;104;242
66;42;34;139;172;311
66;42;35;139;125;264
66;35;48;139;150;289
66;126;74;139;145;284
66;147;51;140;144;284
66;140;51;141;144;285
66;21;18;142;163;305
66;133;44;142;120;262
66;133;45;142;123;265
66;140;55;142;134;276
66;140;58;142;147;289
66;126;72;142;210;352
66;161;5;143;121;264
66;42;25;143;161;304
66;140;48;143;126;269
66;147;54;143;155;298
66;21;1;144;180;324
66;140;49;144;146;290
66;140;60;144;128;272
66;147;58;145;125;270
66;7;66;145;105;250
66;140;41;146;154;300
66;133;46;146;96;242
66;140;46;146;147;293
66;140;54;146;117;263
66;42;29;147;182;329
66;133;39;147;145;292
66;140;40;147;186;333
66;140;43;147;176;323
66;140;50;147;157;304
66;147;56;147;145;292
66;21;9;148;144;292
66;35;55;149;114;263
66;112;61;149;154;303
66;147;53;150;152;302
66;7;63;150;110;260
66;49;64;150;159;309
66;21;4;151;144;295
66;21;10;151;137;288
66;42;27;151;163;314
66;147;57;151;139;290
66;35;44;152;159;311
66;147;47;152;200;352
66;147;49;152;140;292
66;21;6;153;142;295
66;21;17;153;153;306
66;140;45;153;134;287
66;140;47;153;161;314
66;147;55;153;145;298
66;133;38;154;137;291
66;133;40;154;140;294
66;35;45;154;152;306
66;49;62;154;150;304
66;42;24;155;175;330
66;42;32;155;162;317
66;140;53;155;138;293
66;21;2;156;143;299
66;161;9;156;144;300
66;21;16;156;157;313
66;35;47;156;151;307
66;126;78;156;92;248
66;21;13;157;135;292
66;161;15;157;160;317
66;42;26;157;174;331
66;7;61;157;140;297
66;133;37;158;151;309
66;140;37;158;183;341
66;49;60;158;179;337
66;126;77;158;112;270
66;21;15;159;149;308
66;7;62;159;143;302
66;21;8;160;123;283
66;21;12;160;160;320
66;42;28;160;146;306
66;35;41;160;205;365
66;21;11;161;156;317
66;21;30;161;118;279
66;140;42;162;151;313
66;112;58;162;162;324
66;7;64;162;126;288
66;21;3;163;142;305
66;161;11;164;171;335
66;42;22;164;157;321
66;42;31;164;156;320
66;42;30;165;147;312
66;140;39;165;169;334
66;28;86;165;495;660
66;42;21;166;176;342
66;140;35;166;205;371
66;140;38;166;182;348
66;140;44;166;169;335
66;56;74;166;175;341
66;161;10;167;173;340
66;35;49;167;123;290
66;49;59;169;180;349
66;112;60;169;163;332
66;112;52;170;210;380
66;112;53;170;209;379
66;56;75;170;225;395
66;35;43;171;160;331
66;140;25;174;192;366
66;35;42;174;188;362
66;147;50;174;160;334
66;35;46;176;158;334
66;112;59;176;149;325
66;21;5;177;139;316
66;140;28;177;215;392
66;147;43;177;192;369
66;133;34;178;171;349
66;126;69;178;219;397
66;112;47;179;194;373
66;21;14;180;169;349
66;140;34;180;194;374
66;112;57;180;178;358
66;140;29;181;228;409
66;133;33;181;161;342
66;35;40;181;176;357
66;112;41;181;198;379
66;49;58;181;170;351
66;140;27;182;176;358
66;112;40;182;249;431
66;161;12;183;178;361
66;133;31;183;213;396
66;147;42;183;240;423
66;112;51;183;195;378
66;49;57;185;187;372
66;112;46;186;215;401
66;49;51;186;219;405
66;42;20;187;161;348
66;161;14;188;168;356
66;133;35;188;168;356
66;49;52;188;198;386
66;112;54;188;203;391
66;133;36;189;176;365
66;112;42;189;212;401
66;147;44;189;197;386
66;147;48;189;169;358
66;42;23;190;161;351
66;140;26;190;196;386
66;112;55;190;189;379
66;28;88;190;333;523
66;140;31;191;236;427
66;42;6;192;185;377
66;112;43;192;201;393
66;147;45;192;220;412
66;49;50;192;194;386
66;112;44;193;186;379
66;112;56;193;186;379
66;7;59;194;141;335
66;140;24;195;214;409
66;112;48;196;203;399
66;140;21;198;211;409
66;56;73;198;250;448
66;42;16;199;234;433
66;112;49;199;189;388
66;112;45;201;215;416
66;7;58;201;193;394
66;42;19;203;195;398
66;35;37;203;219;422
66;56;72;203;243;446
66;42;2;204;175;379
66;112;50;204;202;406
66;42;3;205;208;413
66;133;26;205;192;397
66;147;41;205;216;421
66;112;39;206;222;428
66;49;49;206;229;435
66;7;55;206;183;389
66;49;46;207;237;444
66;140;20;209;206;415
66;140;23;209;226;435
66;140;33;209;210;419
66;49;54;209;180;389
66;140;30;210;226;436
66;49;55;210;205;415
66;42;1;211;217;428
66;133;25;211;246;457
66;112;38;211;226;437
66;147;46;211;181;392
66;133;27;212;201;413
66;133;32;212;179;391
66;7;60;212;158;370
66;56;69;212;249;461
66;42;5;213;213;426
66;35;38;213;220;433
66;140;32;216;208;424
66;49;47;216;236;452
66;7;57;216;181;397
66;147;36;217;245;462
66;42;0;218;212;430
66;42;4;218;214;432
66;140;22;219;201;420
66;7;56;219;181;400
66;133;24;220;242;462
66;147;37;220;240;460
66;49;39;222;259;481
66;42;9;224;215;439
66;133;23;225;233;458
66;133;29;225;205;430
66;56;71;225;201;426
66;42;18;226;212;438
66;42;7;228;186;414
66;147;40;228;232;460
66;35;39;229;223;452
66;49;43;229;247;476
66;49;53;229;186;415
66;42;17;230;257;487
66;7;52;230;225;455
66;49;56;230;186;416
66;42;13;231;255;486
66;133;28;231;189;420
66;42;10;232;240;472
66;42;15;232;246;478
66;35;36;232;234;466
66;35;35;233;249;482
66;42;14;234;234;468
66;112;32;234;301;535
66;42;8;236;229;465
66;49;42;236;242;478
66;133;22;237;230;467
66;49;45;237;241;478
66;133;30;238;212;450
66;112;36;238;257;495
66;112;37;238;236;474
66;140;1;239;288;527
66;147;38;239;204;443
66;140;4;240;240;480
66;147;39;241;252;493
66;126;70;241;233;474
66;42;11;243;238;481
66;140;3;244;235;479
66;49;41;244;257;501
66;49;44;244;233;477
66;42;12;245;237;482
66;28;82;245;533;778
66;147;34;246;247;493
66;126;65;246;235;481
66;133;21;247;225;472
66;147;35;247;271;518
66;147;33;248;283;531
66;126;71;248;233;481
66;49;48;249;239;488
66;112;35;252;316;568
66;112;34;255;259;514
66;7;54;255;179;434
66;49;40;256;276;532
66;7;44;257;271;528
66;7;49;257;240;497
66;126;67;258;283;541
66;112;29;260;291;551
66;7;46;261;237;498
66;7;48;261;222;483
66;140;5;262;253;515
66;140;19;263;293;556
66;35;27;264;280;544
66;147;32;264;252;516
66;49;37;264;262;526
66;35;31;265;291;556
66;147;29;266;291;557
66;7;51;266;184;450
66;35;34;267;273;540
66;7;53;268;191;459
66;126;66;269;312;581
66;112;27;270;291;561
66;56;67;270;300;570
66;35;32;272;282;554
66;7;43;273;290;563
66;7;50;275;246;521
66;35;26;276;299;575
66;112;28;276;308;584
66;35;25;277;316;593
66;147;30;277;263;540
66;7;45;277;273;550
66;35;21;279;290;569
66;140;2;280;256;536
66;112;33;282;266;548
66;133;19;284;258;542
66;133;20;284;223;507
66;147;27;284;288;572
66;56;70;285;297;582
66;147;31;286;282;568
66;140;6;289;295;584
66;147;21;289;309;598
66;112;25;289;317;606
66;147;25;289;299;588
66;35;33;289;262;551
66;112;31;290;308;598
66;112;30;291;309;600
66;140;0;292;303;595
66;126;63;297;352;649
66;140;8;299;283;582
66;140;12;300;338;638
66;7;47;300;250;550
66;56;68;301;336;637
66;140;18;302;274;576
66;35;28;302;327;629
66;7;42;302;270;572
66;35;24;303;328;631
66;147;26;303;341;644
66;7;39;303;318;621
66;28;85;303;502;805
66;49;36;304;350;654
66;140;16;305;324;629
66;140;13;306;278;584
66;147;23;307;318;625
66;35;29;309;297;606
66;112;26;311;257;568
66;147;28;312;332;644
66;56;66;314;276;590
66;35;30;315;277;592
66;126;73;315;189;504
66;7;40;316;283;599
66;140;17;318;286;604
66;140;11;319;331;650
66;35;23;320;305;625
66;49;33;322;362;684
66;140;15;323;300;623
66;147;24;323;338;661
66;112;3;326;323;649
66;140;7;327;304;631
66;7;41;327;273;600
66;112;21;328;336;664
66;35;22;328;296;624
66;49;32;328;350;678
66;112;23;329;322;651
66;56;64;329;324;653
66;147;22;331;318;649
66;126;64;331;265;596
66;49;35;332;332;664
66;49;38;333;305;638
66;112;1;335;339;674
66;140;9;335;280;615
66;133;16;335;404;739
66;133;17;336;296;632
66;112;22;337;335;672
66;49;31;337;375;712
66;7;38;338;330;668
66;35;20;339;342;681
66;140;10;340;317;657
66;133;18;341;282;623
66;35;19;344;371;715
66;49;25;344;360;704
66;49;34;344;348;692
66;126;62;346;302;648
66;49;27;349;354;703
66;147;20;351;323;674
66;112;2;352;290;642
66;112;24;353;324;677
66;147;4;356;382;738
66;49;29;359;379;738
66;147;1;361;446;807
66;112;20;362;335;697
66;28;84;363;387;750
66;140;14;364;322;686
66;126;68;364;296;660
66;56;65;367;341;708
66;112;7;368;394;762
66;49;21;368;392;760
66;147;19;369;413;782
66;112;4;370;318;688
66;56;61;371;390;761
66;35;12;375;411;786
66;133;13;375;382;757
66;7;34;376;355;731
66;56;63;376;385;761
66;112;5;377;342;719
66;49;28;377;368;745
66;147;3;378;365;743
66;35;18;379;382;761
66;49;30;379;380;759
66;35;1;380;354;734
66;112;9;384;384;768
66;7;37;385;366;751
66;112;6;388;379;767
66;49;26;388;359;747
66;35;2;389;397;786
66;147;2;390;361;751
66;7;31;392;393;785
66;7;32;392;398;790
66;49;2;394;440;834
66;133;6;394;457;851
66;133;15;394;328;722
66;7;33;395;351;746
66;7;36;396;360;756
66;133;7;397;382;779
66;147;7;398;395;793
66;126;60;398;396;794
66;133;2;399;420;819
66;35;14;399;424;823
66;56;62;399;436;835
66;133;9;401;421;822
66;49;24;401;348;749
66;133;4;403;383;786
66;35;15;404;411;815
66;7;35;404;347;751
66;133;12;405;358;763
66;35;3;406;322;728
66;35;9;406;421;827
66;35;5;407;386;793
66;49;23;407;404;811
66;133;11;409;407;816
66;35;13;409;406;815
66;147;5;411;382;793
66;35;6;412;393;805
66;147;13;412;425;837
66;147;6;414;422;836
66;49;22;414;367;781
66;49;1;417;414;831
66;126;61;419;339;758
66;28;83;419;538;957
66;147;0;420;407;827
66;28;81;420;583;1003
66;147;15;421;420;841
66;35;16;421;354;775
66;147;8;422;482;904
66;49;20;422;379;801
66;35;4;424;357;781
66;112;8;425;399;824
66;35;17;425;375;800
66;35;0;426;425;851
66;112;12;426;434;860
66;112;0;428;376;804
66;35;8;428;427;855
66;147;18;428;386;814
66;147;9;430;396;826
66;133;5;431;395;826
66;112;11;431;436;867
66;7;24;431;487;918
66;7;20;435;488;923
66;49;3;439;391;830
66;35;11;439;427;866
66;35;7;441;406;847
66;147;12;441;426;867
66;126;58;442;491;933
66;112;19;443;370;813
66;49;5;446;479;925
66;7;21;446;474;920
66;49;0;447;420;867
66;35;10;447;406;853
66;133;8;450;425;875
66;147;17;452;459;911
66;112;10;454;408;862
66;147;11;454;410;864
66;112;18;455;426;881
66;7;29;455;428;883
66;133;1;457;425;882
66;133;10;458;409;867
66;147;16;458;418;876
66;7;27;459;438;897
66;49;4;460;443;903
66;133;0;464;389;853
66;112;13;464;414;878
66;112;17;467;435;902
66;133;3;469;414;883
66;49;6;469;457;926
66;7;28;469;453;922
66;126;52;469;639;1108
66;7;25;470;464;934
66;133;14;475;419;894
66;7;23;476;476;952
66;112;14;477;441;918
66;126;59;478;331;809
66;147;10;480;446;926
66;7;26;480;505;985
66;112;15;481;458;939
66;49;7;484;425;909
66;112;16;489;465;954
66;49;13;491;553;1044
66;7;22;494;461;955
66;49;8;496;479;975
66;7;30;503;477;980
66;56;55;504;532;1036
66;49;19;513;487;1000
66;49;11;518;496;1014
66;49;16;518;533;1051
66;49;12;521;524;1045
66;56;59;521;468;989
66;147;14;526;443;969
66;56;60;526;476;1002
66;49;9;527;484;1011
66;49;18;527;497;1024
66;49;17;528;537;1065
66;49;10;534;548;1082
66;49;15;534;545;1079
66;28;80;539;934;1473
66;56;57;542;572;1114
66;126;53;547;619;1166
66;56;58;554;471;1025
66;7;3;558;538;1096
66;126;51;571;583;1154
66;7;19;579;534;1113
66;126;56;583;474;1057
66;56;56;585;591;1176
66;7;6;587;610;1197
66;126;43;588;701;1289
66;126;54;588;522;1110
66;49;14;590;533;1123
66;126;49;596;647;1243
66;126;46;604;627;1231
66;7;18;606;557;1163
66;126;57;609;430;1039
66;126;50;610;562;1172
66;7;1;612;597;1209
66;28;77;612;1228;1840
66;7;5;617;631;1248
66;7;7;621;678;1299
66;7;4;624;577;1201
66;126;41;626;646;1272
66;56;51;629;553;1182
66;28;79;643;802;1445
66;7;2;651;657;1308
66;126;55;654;443;1097
66;56;53;655;625;1280
66;56;54;659;580;1239
66;56;49;660;640;1300
66;126;48;666;593;1259
66;7;17;668;653;1321
66;7;16;669;710;1379
66;7;13;670;689;1359
66;126;37;670;907;1577
66;28;78;675;940;1615
66;56;52;681;621;1302
66;7;8;682;688;1370
66;7;15;690;670;1360
66;126;44;695;713;1408
66;7;9;702;673;1375
66;7;10;706;737;1443
66;56;50;707;704;1411
66;7;11;708;632;1340
66;7;0;714;707;1421
66;7;12;716;670;1386
66;126;47;721;627;1348
66;56;44;722;730;1452
66;126;42;727;700;1427
66;126;39;733;758;1491
66;56;48;737;752;1489
66;126;45;748;749;1497
66;56;47;748;724;1472
66;28;71;767;1283;2050
66;56;41;783;824;1607
66;126;38;784;805;1589
66;28;76;784;959;1743
66;126;40;787;696;1483
66;126;36;796;855;1651
66;56;42;803;780;1583
66;56;46;807;732;1539
66;7;14;809;667;1476
66;56;43;810;737;1547
66;56;45;816;761;1577
66;28;74;846;966;1812
66;56;40;868;919;1787
66;126;34;870;931;1801
66;56;38;874;941;1815
66;56;37;879;968;1847
66;28;73;911;1100;2011
66;126;33;915;1046;1961
66;126;29;916;1114;2030
66;126;35;919;1034;1953
66;28;75;926;1101;2027
66;56;39;939;857;1796
66;126;31;941;1024;1965
66;56;36;959;1026;1985
66;28;72;980;1264;2244
66;126;27;987;886;1873
66;126;22;1000;1155;2155
66;56;33;1010;1116;2126
66;126;25;1027;932;1959
66;28;69;1029;1326;2355
66;56;27;1031;1081;2112
66;126;26;1038;995;2033
66;126;21;1074;1252;2326
66;56;31;1077;1176;2253
66;56;26;1080;1151;2231
66;56;34;1091;1114;2205
66;28;68;1097;1443;2540
66;28;70;1103;1571;2674
66;126;30;1114;1317;2431
66;126;23;1122;1212;2334
66;126;20;1135;1218;2353
66;56;24;1137;1216;2353
66;126;24;1137;1084;2221
66;126;32;1144;1019;2163
66;56;35;1150;1174;2324
66;56;32;1155;1222;2377
66;56;30;1168;1297;2465
66;56;25;1183;1213;2396
66;126;28;1183;1090;2273
66;56;23;1186;1255;2441
66;56;28;1227;1238;2465
66;56;29;1232;1175;2407
66;28;67;1242;1579;2821
66;56;21;1248;1219;2467
66;56;22;1257;1288;2545
66;28;66;1349;1677;3026
66;56;19;1412;1509;2921
66;56;20;1433;1402;2835
66;28;63;1476;1846;3322
66;126;19;1493;1452;2945
66;126;3;1502;1464;2966
66;28;64;1521;1736;3257
66;126;6;1532;1647;3179
66;126;4;1542;1541;3083
66;126;17;1546;1474;3020
66;126;9;1583;1600;3183
66;126;12;1586;1561;3147
66;126;15;1596;1833;3429
66;28;61;1613;1918;3531
66;126;10;1616;1535;3151
66;126;2;1624;1444;3068
66;28;65;1627;1743;3370
66;126;18;1649;1562;3211
66;126;8;1650;1583;3233
66;126;5;1655;1612;3267
66;56;17;1660;1890;3550
66;28;62;1667;1968;3635
66;126;14;1668;1919;3587
66;56;18;1683;1630;3313
66;126;0;1686;1554;3240
66;56;7;1687;1868;3555
66;126;7;1692;1353;3045
66;56;1;1713;1656;3369
66;126;13;1718;1612;3330
66;126;16;1737;1564;3301
66;56;16;1747;1770;3517
66;126;11;1756;1683;3439
66;56;9;1768;1766;3534
66;56;6;1783;1593;3376
66;56;12;1801;1867;3668
66;126;1;1812;1504;3316
66;56;3;1846;1754;3600
66;28;57;1849;2411;4260
66;56;15;1854;1809;3663
66;56;14;1859;1910;3769
66;56;4;1877;1614;3491
66;56;11;1887;1853;3740
66;28;58;1917;2342;4259
66;56;2;1929;1787;3716
66;56;13;1929;1735;3664
66;28;59;1936;2346;4282
66;56;10;1940;1944;3884
66;56;5;1942;1749;3691
66;56;8;1949;1841;3790
66;56;0;1977;1931;3908
66;28;60;1978;2396;4374
66;28;55;2036;2596;4632
66;28;56;2054;2808;4862
66;28;52;2091;2838;4929
66;28;53;2158;2838;4996
66;28;54;2161;2725;4886
66;28;50;2205;2866;5071
66;28;51;2252;2519;4771
66;28;46;2399;2852;5251
66;28;47;2439;2848;5287
66;28;49;2473;2808;5281
66;28;48;2604;2898;5502
66;28;43;2658;3026;5684
66;28;45;2669;3081;5750
66;28;44;2678;3133;5811
66;28;42;2897;3379;6276
66;28;39;2961;3525;6486
66;28;41;3060;3250;6310
66;28;38;3232;3763;6995
66;28;36;3380;4125;7505
66;28;37;3412;3283;6695
66;28;40;3412;3473;6885
66;28;34;3640;4170;7810
66;28;32;3782;4317;8099
66;28;35;3796;4467;8263
66;28;33;3811;4322;8133
66;28;31;4003;4785;8788
66;28;28;4028;4661;8689
66;28;30;4057;4572;8629
66;28;29;4121;4402;8523
66;28;26;4208;4283;8491
66;28;25;4272;4849;9121
66;28;23;4315;4784;9099
66;28;27;4323;4306;8629
66;28;3;4369;4490;8859
66;28;24;4431;4603;9034
66;28;4;4565;4740;9305
66;28;22;4572;5329;9901
66;28;21;4735;4762;9497
66;28;5;4826;4496;9322
66;28;20;4831;4847;9678
66;28;1;4907;4739;9646
66;28;6;4927;4670;9597
66;28;2;5005;4572;9577
66;28;19;5057;5756;10813
66;28;13;5106;4666;9772
66;28;8;5146;5079;10225
66;28;0;5234;5046;10280
66;28;14;5236;5245;10481
66;28;7;5275;4802;10077
66;28;9;5319;4820;10139
66;28;10;5373;4939;10312
66;28;11;5373;5052;10425
66;28;17;5444;4973;10417
66;28;18;5482;5814;11296
66;28;16;5531;5800;11331
66;28;12;5536;4491;10027
66;28;15;5588;5380;10968
66;91;79;0;1;1
66;91;82;0;2;2
66;105;83;0;2;2
66;77;84;0;9;9
66;91;85;0;4;4
66;70;86;0;4;4
66;105;87;0;3;3
66;105;88;0;1;1
66;119;89;0;3;3
66;105;90;0;1;1
66;14;91;0;1;1
66;21;91;0;8;8
66;105;91;0;1;1
66;119;91;0;2;2
66;154;91;0;1;1
66;161;91;0;1;1
66;21;92;0;2;2
66;91;92;0;1;1
66;119;92;0;1;1
66;161;92;0;1;1
66;77;93;0;2;2
66;84;93;0;4;4
66;7;94;0;3;3
66;14;94;0;1;1
66;35;94;0;3;3
66;42;94;0;4;4
66;70;94;0;1;1
66;119;94;0;1;1
66;154;94;0;2;2
66;35;95;0;2;2
66;42;95;0;2;2
66;49;95;0;2;2
66;70;95;0;2;2
66;84;95;0;1;1
66;126;95;0;16;16
66;7;96;0;3;3
66;14;96;0;2;2
66;21;96;0;1;1
66;49;96;0;2;2
66;126;96;0;1;1
66;133;96;0;1;1
66;140;96;0;2;2
66;35;97;0;1;1
66;49;97;0;1;1
66;77;97;0;2;2
66;119;97;0;2;2
66;133;97;0;1;1
66;147;97;0;3;3
66;154;97;0;1;1
66;14;98;0;1;1
66;42;98;0;1;1
66;77;98;0;1;1
66;98;98;0;1;1
66;112;98;0;2;2
66;126;98;0;1;1
66;147;98;0;3;3
66;154;98;0;1;1
66;7;99;0;1;1
66;35;99;0;1;1
66;49;99;0;2;2
66;56;99;0;2;2
66;63;99;0;1;1
66;112;99;0;1;1
66;161;99;0;1;1
66;56;100;0;1;1
66;70;100;0;1;1
66;133;100;0;1;1
66;161;100;0;1;1
66;63;101;0;1;1
66;77;101;0;1;1
66;140;101;0;1;1
66;21;102;0;1;1
66;42;102;0;1;1
66;77;102;0;1;1
66;161;102;0;2;2
66;14;103;0;1;1
66;56;104;0;1;1
66;77;104;0;1;1
66;98;104;0;1;1
66;42;105;0;1;1
66;161;105;0;1;1
66;7;109;0;1;1
66;56;110;0;4;4
